datetime,preclose,predeal,open,high,low,close,deal,up1,up2,volume,cash,keep
20140102,4006,4031,4022,4119,4022,4105,4084,74,53,10796,66145.96 ,19056
20140103,4105,4084,4091,4127,4075,4103,4096,19,12,11120,68337.09 ,16388
20140106,4103,4096,4101,4136,4078,4088,4105,-8,9,6352,39120.64 ,14788
20140107,4088,4105,4080,4112,4070,4090,4093,-15,-12,5504,33799.66 ,12572
20140108,4090,4093,4071,4081,3984,3995,4014,-98,-79,8292,49938.14 ,11312
20140109,3995,4014,4008,4023,3926,3965,3961,-49,-53,4164,24745.09 ,10456
20140110,3965,3961,3969,4013,3936,3996,3975,35,14,4196,25024.73 ,10732
20140113,3996,3975,3990,4190,3849,4050,4028,75,53,868,5245.58 ,10580
20140114,4050,4028,4022,4090,4011,4075,4076,47,48,496,3032.96 ,10712
20140115,4075,4076,4092,4098,4021,4045,4043,-31,-33,856,5192.08 ,10452
20140102,4033,4059,4062,4164,4057,4133,4113,74,54,1768,10909.73 ,9174
20140103,4133,4113,4122,4154,4099,4132,4123,19,10,1940,12000.51 ,9324
20140106,4132,4123,4125,4163,4104,4113,4130,-10,7,2384,14771.57 ,9348
20140107,4113,4130,4100,4135,4100,4113,4118,-17,-12,2440,15074.24 ,9616
20140108,4113,4118,4091,4104,4009,4019,4042,-99,-76,2574,15606.60 ,9572
20140109,4019,4042,4029,4040,3949,3978,3987,-64,-55,3110,18603.30 ,9630
20140110,3978,3987,4005,4041,3967,4014,3996,27,9,2134,12792.11 ,9594
20140113,4014,3996,4021,4120,3993,4070,4071,74,75,3716,22694.35 ,9512
20140114,4070,4071,4070,4120,4029,4108,4074,37,3,1782,10892.30 ,9406
20140115,4108,4074,4079,4128,4050,4065,4079,-9,5,1396,8542.93 ,9264
20140116,4065,4079,4043,4083,4033,4059,4066,-20,-13,898,5477.14 ,9274
20140117,4059,4066,4066,4080,4045,4065,4063,-1,-3,1944,11848.14 ,9290
20140120,4065,4063,4070,4102,4070,4098,4089,35,26,2374,14562.95 ,9176
20140121,4098,4089,4100,4107,4065,4076,4084,-13,-5,1360,8331.46 ,8876
20140122,4076,4084,4050,4050,4008,4020,4025,-64,-59,1604,9684.97 ,8830
20140123,4020,4025,4019,4033,3982,3994,3997,-31,-28,2034,12197.33 ,9626
20140124,3994,3997,4058,4065,4030,4045,4049,48,52,2482,15076.25 ,8922
20140127,4045,4049,4081,4084,4010,4029,4038,-20,-11,1854,11232.29 ,9060
20140128,4029,4038,4020,4030,4009,4019,4018,-19,-20,3298,19880.86 ,7636
20140129,4019,4018,4017,4020,3993,4012,4003,-6,-15,1152,6917.30 ,7618
20140130,4012,4003,4017,4028,3969,3983,4000,-20,-3,1080,6480.32 ,7588
20140207,3983,4000,4018,4130,3984,4015,4013,15,13,1532,9221.91 ,7396
20140210,4015,4013,4027,4065,4004,4065,4027,52,14,3464,20927.63 ,7132
20140211,4065,4027,4076,4085,4036,4044,4053,17,26,1144,6956.50 ,7072
20140212,4044,4053,4120,4120,4021,4029,4045,-24,-8,1756,10655.02 ,7168
20140213,4029,4045,4060,4060,4020,4050,4052,5,7,568,3452.38 ,7256
20140214,4050,4052,4054,4148,4054,4140,4090,88,38,912,5595.61 ,7584
20140217,4140,4090,4190,4335,4189,4335,4241,245,151,288,1832.11 ,7740
20140102,4057,4078,4101,4165,4100,4158,4138,80,60,1088,6753.62 ,5620
20140103,4158,4138,4135,4174,4124,4150,4152,12,14,830,5170.10 ,5376
20140106,4150,4152,4136,4186,4132,4132,4158,-20,6,628,3916.84 ,5526
20140107,4132,4158,4129,4161,4116,4138,4143,-20,-15,794,4934.84 ,5498
20140108,4138,4143,4123,4123,4029,4036,4053,-107,-90,670,4073.84 ,5606
20140109,4036,4053,4058,4058,3959,4006,4006,-47,-47,848,5096.75 ,5512
20140110,4006,4006,4044,4049,3987,4046,4002,40,-4,588,3530.60 ,5638
20140113,4046,4002,4014,4147,4014,4099,4119,97,117,798,4931.47 ,5500
20140114,4099,4119,4090,4145,4047,4124,4123,5,4,1424,8806.95 ,5598
20140115,4124,4123,4113,4160,4078,4090,4099,-33,-24,2008,12349.01 ,5264
20140116,4090,4099,4064,4106,4064,4085,4090,-14,-9,812,4982.63 ,5294
20140117,4085,4090,4066,4102,4066,4088,4089,-2,-1,988,6061.21 ,5316
20140120,4088,4089,4093,4127,4093,4117,4113,28,24,634,3911.92 ,5372
20140121,4117,4113,4130,4152,4090,4094,4106,-19,-7,1214,7478.33 ,5362
20140122,4094,4106,4051,4063,4028,4036,4049,-70,-57,748,4543.06 ,5466
20140123,4036,4049,4041,4052,4005,4019,4021,-30,-28,578,3486.57 ,5568
20140124,4019,4021,4072,4088,4053,4068,4070,47,49,1376,8401.38 ,5548
20140127,4068,4070,4125,4125,4030,4052,4054,-18,-16,772,4695.58 ,5718
20140128,4052,4054,4040,4051,4031,4044,4042,-10,-12,546,3310.72 ,5856
20140129,4044,4042,4038,4040,4014,4026,4023,-16,-19,812,4900.73 ,5844
20140130,4026,4023,4035,4050,3991,4000,4013,-23,-10,982,5912.46 ,5914
20140207,4000,4013,4043,4047,4021,4036,4034,23,21,942,5700.26 ,6244
20140210,4036,4034,4055,4089,4027,4086,4055,52,21,3640,22144.23 ,6800
20140211,4086,4055,4103,4110,4063,4069,4079,14,24,1488,9104.58 ,7014
20140212,4069,4079,4089,4090,4050,4074,4068,-5,-11,1498,9143.04 ,7384
20140213,4074,4068,4097,4097,4071,4074,4079,6,11,448,2741.52 ,7444
20140214,4074,4079,4079,4185,4075,4181,4149,102,70,1592,9908.07 ,7648
20140217,4181,4149,4242,4397,4219,4395,4329,246,180,2668,17326.11 ,7652
20140218,4395,4329,4388,4410,4316,4338,4357,9,28,4160,27188.87 ,7644
20140219,4338,4357,4322,4388,4320,4349,4354,-8,-3,6096,39820.06 ,6818
20140220,4349,4354,4364,4377,4278,4309,4326,-45,-28,5062,32847.89 ,6480
20140221,4309,4326,4298,4338,4298,4318,4315,-8,-11,1950,12621.90 ,6390
20140224,4318,4315,4336,4345,4268,4327,4306,12,-9,4586,29625.52 ,7572
20140225,4327,4306,4367,4379,4329,4329,4349,23,43,4004,26125.04 ,9108
20140226,4329,4349,4329,4389,4310,4363,4344,14,-5,1490,9710.51 ,9354
20140227,4363,4344,4299,4300,4179,4204,4225,-140,-119,3006,19050.83 ,9310
20140228,4204,4225,4216,4238,4201,4211,4215,-14,-10,2640,16694.82 ,9380
20140303,4211,4215,4226,4300,4206,4266,4254,51,39,2644,16873.36 ,8256
20140304,4266,4254,4255,4280,4230,4233,4256,-21,2,4104,26203.04 ,7956
20140305,4233,4256,4220,4235,4207,4224,4223,-32,-33,1928,12215.16 ,7648
20140306,4224,4223,4239,4241,4211,4226,4225,3,2,3156,20004.16 ,7584
20140307,4226,4225,4228,4283,4224,4272,4265,47,40,2684,17174.31 ,7972
20140310,4272,4265,4265,4265,4102,4115,4137,-150,-128,3644,22614.91 ,10076
20140311,4115,4137,4136,4174,4130,4148,4139,11,2,2456,15250.94 ,8680
20140312,4148,4139,4176,4210,4130,4193,4179,54,40,1100,6895.66 ,8232
20140313,4193,4179,4231,4265,4230,4230,4249,51,70,1084,6908.98 ,7288
20140314,4230,4249,4235,4237,4235,4237,4236,-12,-13,24,152.50 ,7288
20140317,4237,4236,4234,4255,4234,4250,4244,14,8,352,2240.99 ,7324
20140102,4077,4089,4111,4187,4111,4182,4166,93,77,110,687.55 ,424
20140103,4182,4166,4167,4181,4150,4178,4163,12,-3,40,249.84 ,436
20140106,4178,4163,4160,4195,4153,4153,4166,-10,3,42,262.51 ,436
20140107,4153,4166,4169,4174,4152,4156,4161,-10,-5,30,187.26 ,438
20140108,4156,4161,4145,4145,4044,4053,4075,-108,-86,46,281.21 ,414
20140109,4053,4075,4075,4076,3993,4005,4030,-70,-45,110,665.06 ,360
20140110,4005,4030,4050,4080,3997,4049,4018,19,-12,596,3592.34 ,400
20140113,4049,4018,4055,4163,4031,4110,4106,92,88,634,3904.89 ,492
20140114,4110,4106,4078,4161,4070,4161,4119,55,13,68,420.24 ,486
20140115,4161,4119,4131,4156,4092,4092,4124,-27,5,36,222.71 ,486
20140116,4092,4124,4091,4114,4080,4106,4097,-18,-27,42,258.13 ,488
20140117,4106,4097,4094,4114,4094,4108,4105,11,8,16,98.53 ,484
20140120,4108,4105,4122,4146,4112,4137,4133,32,28,300,1860.29 ,514
20140121,4137,4133,4147,4147,4101,4110,4139,-23,6,130,807.12 ,550
20140122,4110,4139,4071,4071,4042,4056,4060,-83,-79,86,523.80 ,546
20140123,4056,4060,4057,4060,4027,4027,4039,-33,-21,48,290.87 ,508
20140124,4027,4039,4086,4113,4084,4094,4091,55,52,50,306.87 ,502
20140127,4094,4091,4115,4115,4059,4066,4074,-25,-17,56,342.23 ,494
20140128,4066,4074,4061,4075,4054,4070,4063,-4,-11,34,207.23 ,488
20140129,4070,4063,4057,4061,4034,4042,4047,-21,-16,30,182.16 ,482
20140130,4042,4047,4065,4065,4012,4021,4030,-26,-17,42,253.92 ,478
20140207,4021,4030,4066,4066,4050,4050,4053,20,23,18,109.45 ,480
20140210,4050,4053,4061,4111,4060,4104,4075,51,22,66,403.44 ,486
20140211,4104,4075,4133,4135,4090,4090,4107,15,32,128,788.71 ,514
20140212,4090,4107,4107,4107,4069,4090,4088,-17,-19,54,331.16 ,520
20140213,4090,4088,4109,4113,4090,4090,4101,2,13,112,689.01 ,554
20140214,4090,4101,4104,4204,4104,4203,4188,102,87,168,1055.50 ,604
20140217,4203,4188,4252,4439,4250,4410,4376,222,188,508,3334.73 ,732
20140218,4410,4376,4385,4438,4340,4373,4401,-3,25,418,2760.02 ,722
20140219,4373,4401,4342,4410,4342,4369,4382,-32,-19,756,4969.69 ,1000
20140220,4369,4382,4388,4407,4301,4321,4361,-61,-21,170,1112.19 ,988
20140221,4321,4361,4337,4356,4326,4340,4342,-21,-19,120,781.68 ,948
20140224,4340,4342,4323,4367,4305,4346,4344,4,2,224,1459.65 ,960
20140225,4346,4344,4368,4436,4352,4352,4388,8,44,48,315.99 ,964
20140226,4352,4388,4359,4421,4339,4421,4376,33,-12,70,459.53 ,960
20140227,4421,4376,4324,4356,4199,4226,4259,-150,-117,142,907.37 ,986
20140228,4226,4259,4242,4263,4224,4243,4240,-16,-19,466,2964.30 ,1144
20140303,4243,4240,4275,4286,4228,4277,4268,37,28,374,2394.47 ,1310
20140304,4277,4268,4283,4297,4237,4237,4276,-31,8,214,1372.91 ,1302
20140305,4237,4276,4233,4253,4220,4240,4240,-36,-36,364,2315.56 ,1340
20140306,4240,4240,4242,4253,4231,4237,4241,-3,1,292,1857.93 ,1268
20140307,4237,4241,4239,4299,4239,4279,4271,38,30,296,1896.44 ,1412
20140310,4279,4271,4271,4271,4107,4111,4173,-160,-98,1246,7800.02 ,1248
20140311,4111,4173,4153,4191,4121,4159,4165,-14,-8,684,4274.31 ,1300
20140312,4159,4165,4196,4215,4091,4196,4186,31,21,618,3880.50 ,1430
20140313,4196,4186,4203,4265,4191,4238,4236,52,50,422,2681.87 ,1518
20140314,4238,4236,4212,4249,4208,4237,4226,1,-10,884,5604.88 ,1632
20140317,4237,4226,4334,4348,4237,4262,4270,36,44,810,5188.49 ,1764
20140318,4262,4270,4256,4258,4188,4207,4204,-63,-66,2332,14706.06 ,2962
20140319,4207,4204,4150,4195,4123,4182,4168,-22,-36,1264,7903.76 ,3104
20140320,4182,4168,4165,4215,4141,4165,4170,-3,2,1714,10722.62 ,3040
20140321,4165,4170,4110,4154,4110,4143,4145,-27,-25,1208,7510.85 ,3226
20140324,4143,4145,4161,4163,4115,4122,4126,-23,-19,564,3490.88 ,3340
20140325,4122,4126,4120,4120,4092,4115,4103,-11,-23,1344,8273.42 ,3420
20140326,4115,4103,4103,4136,4103,4136,4122,33,19,1152,7123.55 ,3310
20140327,4136,4122,4118,4121,4085,4095,4091,-27,-31,802,4922.67 ,2830
20140328,4095,4091,4084,4110,4084,4105,4103,14,12,876,5391.78 ,2978
20140331,4105,4103,4104,4123,4084,4084,4102,-19,-1,480,2953.51 ,2950
20140401,4084,4102,4087,4090,4069,4088,4083,-14,-19,1150,7044.79 ,2984
20140402,4088,4083,4094,4098,4086,4091,4091,8,8,76,466.37 ,2924
20140403,4091,4091,4097,4106,4095,4106,4101,15,10,472,2903.65 ,2856
20140404,4106,4101,4095,4101,4095,4100,4097,-1,-4,388,2384.45 ,2564
20140408,4100,4097,4112,4139,4110,4128,4119,31,22,620,3830.91 ,2760
20140409,4128,4119,4146,4146,4122,4134,4136,15,17,236,1464.31 ,2784
20140410,4134,4136,4095,4148,4095,4140,4128,4,-8,408,2526.45 ,2772
20140411,4140,4128,4150,4150,4135,4135,4136,7,8,212,1315.27 ,2788
20140414,4135,4136,4140,4149,4130,4148,4139,12,3,524,3253.70 ,2852
20140415,4148,4139,4121,4158,4094,4094,4136,-45,-3,1104,6849.77 ,2196
20140102,4077,4102,4118,4220,4105,4197,4165,95,63,2858,17858.35 ,1920
20140103,4197,4165,4178,4217,4158,4192,4180,27,15,3124,19589.94 ,2136
20140106,4192,4180,4193,4231,4162,4176,4185,-4,5,3216,20189.02 ,1906
20140107,4176,4185,4155,4202,4155,4174,4180,-11,-5,2476,15526.81 ,1686
20140108,4174,4180,4148,4167,4058,4068,4103,-112,-77,2034,12519.63 ,1742
20140109,4068,4103,4083,4098,3993,4031,4037,-72,-66,2788,16885.46 ,1840
20140110,4031,4037,4055,4096,4012,4066,4048,29,11,3244,19702.07 ,2110
20140113,4066,4048,4080,4180,4043,4126,4120,78,72,3350,20703.67 ,2018
20140114,4126,4120,4126,4181,4078,4156,4130,36,10,2872,17793.89 ,2150
20140115,4156,4130,4136,4190,4109,4123,4136,-7,6,3318,20585.18 ,2012
20140116,4123,4136,4117,4144,4090,4121,4118,-15,-18,2586,15974.24 ,1918
20140117,4121,4118,4118,4140,4099,4124,4125,6,7,1234,7635.69 ,1814
20140120,4124,4125,4130,4167,4129,4154,4150,29,25,1004,6250.83 ,1820
20140121,4154,4150,4182,4182,4126,4129,4150,-21,0,582,3623.57 ,1842
20140122,4129,4150,4086,4094,4055,4075,4076,-75,-74,1290,7887.45 ,1814
20140123,4075,4076,4081,4084,4000,4054,4048,-22,-28,3682,22357.47 ,1812
20140124,4054,4048,4103,4133,4096,4105,4109,57,61,1924,11859.62 ,1840
20140127,4105,4109,4144,4144,4066,4083,4102,-26,-7,1216,7483.09 ,1860
20140128,4083,4102,4079,4092,4063,4082,4077,-20,-25,820,5015.80 ,1816
20140129,4082,4077,4081,4085,4049,4064,4065,-13,-12,1062,6475.85 ,1864
20140130,4064,4065,4094,4094,4024,4044,4060,-21,-5,1632,9940.47 ,1834
20140207,4044,4060,4077,4099,4061,4080,4076,20,16,532,3253.32 ,1780
20140210,4080,4076,4085,4132,4065,4132,4092,56,16,1982,12165.71 ,1802
20140211,4132,4092,4149,4158,4109,4117,4133,25,41,1272,7885.94 ,1876
20140212,4117,4133,4128,4139,4090,4118,4120,-15,-13,2398,14821.82 ,1932
20140213,4118,4120,4148,4148,4114,4120,4124,0,4,728,4504.24 ,1810
20140214,4120,4124,4125,4230,4119,4228,4197,104,73,2794,17592.44 ,2138
20140217,4228,4197,4282,4448,4265,4417,4376,220,179,5802,38085.41 ,3610
20140218,4417,4376,4428,4454,4361,4387,4415,11,39,4306,28520.07 ,3232
20140219,4387,4415,4371,4444,4361,4400,4402,-15,-13,6216,41046.68 ,4742
20140220,4400,4402,4398,4434,4324,4361,4377,-41,-25,5110,33550.37 ,4724
20140221,4361,4377,4360,4389,4343,4365,4368,-12,-9,2094,13720.64 ,4508
20140224,4365,4368,4383,4393,4308,4381,4366,13,-2,3796,24863.02 ,4598
20140225,4381,4366,4412,4429,4380,4380,4406,14,40,1950,12889.76 ,4178
20140226,4380,4406,4374,4440,4360,4433,4388,27,-18,1552,10217.52 ,3992
20140227,4433,4388,4366,4366,4230,4254,4289,-134,-99,1604,10319.81 ,3792
20140228,4254,4289,4278,4299,4251,4257,4271,-32,-18,594,3806.05 ,3726
20140303,4257,4271,4268,4324,4251,4306,4287,35,16,1868,12013.17 ,3710
20140304,4306,4287,4301,4331,4260,4260,4301,-27,14,1644,10607.36 ,3554
20140305,4260,4301,4246,4277,4238,4269,4260,-32,-41,2660,16998.16 ,3872
20140306,4269,4260,4255,4280,4248,4258,4263,-2,3,570,3645.56 ,3852
20140307,4258,4263,4261,4328,4256,4309,4287,46,24,504,3241.16 ,3746
20140310,4309,4287,4299,4299,4121,4143,4184,-144,-103,2878,18063.01 ,3780
20140311,4143,4184,4174,4208,4153,4185,4177,1,-7,604,3784.89 ,3736
20140312,4185,4177,4234,4248,4148,4212,4205,35,28,788,4970.86 ,3576
20140313,4212,4205,4233,4293,4217,4254,4264,49,59,648,4144.78 ,3576
20140314,4254,4264,4223,4260,4223,4248,4249,-16,-15,694,4423.73 ,3496
20140317,4248,4249,4346,4366,4254,4286,4310,37,61,842,5443.66 ,3586
20140318,4286,4310,4277,4279,4208,4227,4240,-83,-70,582,3701.81 ,3638
20140319,4227,4240,4175,4206,4140,4188,4180,-52,-60,648,4063.08 ,3666
20140320,4188,4180,4172,4215,4150,4178,4177,-2,-3,418,2619.41 ,3780
20140321,4178,4177,4141,4165,4122,4154,4149,-23,-28,416,2589.55 ,3804
20140324,4154,4149,4167,4178,4130,4135,4144,-14,-5,366,2275.28 ,3826
20140325,4135,4144,4134,4134,4103,4121,4113,-23,-31,662,4085.08 ,3710
20140326,4121,4113,4124,4146,4114,4146,4130,33,17,618,3828.53 ,3606
20140327,4146,4130,4146,4146,4087,4111,4104,-19,-26,386,2376.64 ,3594
20140328,4111,4104,4111,4125,4101,4125,4113,21,9,144,888.60 ,3584
20140331,4125,4113,4122,4140,4107,4111,4124,-2,11,198,1225.06 ,3546
20140401,4111,4124,4122,4125,4077,4099,4095,-25,-29,3110,19104.52 ,3734
20140402,4099,4095,4106,4110,4099,4106,4103,11,8,526,3237.83 ,3416
20140403,4106,4103,4150,4150,4106,4120,4126,17,23,566,3503.51 ,3386
20140404,4120,4126,4101,4111,4098,4104,4104,-22,-22,98,603.33 ,3386
20140408,4104,4104,4115,4150,4112,4148,4128,44,24,250,1548.19 ,3400
20140409,4148,4128,4151,4158,4136,4140,4148,12,20,162,1007.98 ,3448
20140410,4140,4148,4099,4150,4089,4139,4127,-9,-21,604,3739.53 ,3226
20140411,4139,4127,4148,4155,4132,4137,4139,10,12,522,3241.30 ,3256
20140414,4137,4139,4135,4150,4135,4147,4145,8,6,108,671.61 ,3214
20140415,4147,4145,4151,4152,4096,4096,4117,-49,-28,790,4878.93 ,3598
20140416,4096,4117,4095,4095,4038,4057,4057,-60,-60,1086,6609.24 ,3218
20140417,4057,4057,4079,4079,4047,4051,4058,-6,1,458,2788.01 ,3168
20140418,4051,4058,4062,4065,4042,4050,4052,-8,-6,338,2054.40 ,3212
20140421,4050,4052,4051,4051,3979,3987,3991,-65,-61,2336,13985.01 ,3472
20140422,3987,3991,3994,4017,3988,4007,3999,16,8,1180,7078.88 ,3432
20140423,4007,3999,4005,4033,3998,4012,4015,13,16,2330,14032.79 ,3840
20140424,4012,4015,4010,4022,4008,4020,4017,5,2,952,5736.98 ,3554
20140425,4020,4017,4000,4131,4000,4074,4059,57,42,988,6016.71 ,3528
20140428,4074,4059,4086,4115,4086,4108,4103,49,44,804,4948.85 ,3376
20140429,4108,4103,4098,4113,4082,4088,4091,-15,-12,472,2896.58 ,3472
20140430,4088,4091,4082,4090,4050,4050,4076,-41,-15,338,2066.56 ,3436
20140505,4050,4076,4093,4101,4086,4096,4093,20,17,1016,6238.06 ,4088
20140506,4096,4093,4095,4111,4090,4111,4097,18,4,316,1942.16 ,4180
20140507,4111,4097,4103,4120,4102,4108,4111,11,14,252,1554.08 ,4288
20140508,4108,4111,4101,4101,4062,4073,4072,-38,-39,324,1979.02 ,4324
20140509,4073,4072,4077,4083,4066,4081,4074,9,2,876,5353.97 ,4216
20140512,4081,4074,4084,4126,4082,4108,4100,34,26,1100,6766.62 ,4444
20140513,4108,4100,4200,4200,4120,4130,4149,30,49,1488,9261.07 ,3528
20140514,4130,4149,4000,4140,4000,4140,4126,-9,-23,460,2847.24 ,3472
20140515,4140,4126,4220,4220,4080,4131,4176,5,50,468,2932.02 ,3528
20140102,4099,4136,4118,4226,4117,4213,4191,77,55,1602996,10077244.53 ,668218
20140103,4213,4191,4196,4238,4175,4213,4198,22,7,2761576,17391428.93 ,625652
20140106,4213,4198,4215,4250,4181,4194,4205,-4,7,2672588,16857889.25 ,601888
20140107,4194,4205,4181,4225,4171,4193,4201,-12,-4,2765338,17426936.59 ,607500
20140108,4193,4201,4170,4187,4080,4088,4126,-113,-75,3285602,20334864.12 ,640120
20140109,4088,4126,4100,4117,4010,4050,4050,-76,-76,3737784,22710085.61 ,622260
20140110,4050,4050,4062,4117,4026,4084,4055,34,5,3293378,20033634.63 ,589882
20140113,4084,4055,4098,4203,4054,4144,4139,89,84,4218540,26192698.53 ,603216
20140114,4144,4139,4135,4205,4096,4178,4149,39,10,3671768,22852634.17 ,603400
20140115,4178,4149,4167,4212,4125,4142,4165,-7,16,3981698,24877408.25 ,591432
20140116,4142,4165,4118,4164,4107,4139,4136,-26,-29,3026456,18776390.43 ,581086
20140117,4139,4136,4125,4163,4120,4143,4144,7,8,2169836,13489967.60 ,573502
20140120,4143,4144,4151,4188,4146,4178,4168,34,24,2118776,13247416.98 ,583554
20140121,4178,4168,4185,4193,4142,4152,4171,-16,3,1309466,8193315.51 ,569326
20140122,4152,4171,4102,4115,4071,4090,4096,-81,-75,2258252,13875796.59 ,559418
20140123,4090,4096,4099,4106,4051,4073,4084,-23,-12,1559286,9553324.01 ,576600
20140124,4073,4084,4123,4155,4112,4124,4130,40,46,2530326,15678475.43 ,523948
20140127,4124,4130,4159,4164,4079,4102,4123,-28,-7,2117330,13097510.24 ,538122
20140128,4102,4123,4100,4115,4077,4102,4097,-21,-26,1812776,11142177.25 ,515202
20140129,4102,4097,4101,4103,4064,4085,4084,-12,-13,1319710,8086275.80 ,489422
20140130,4085,4084,4098,4112,4040,4061,4083,-23,-1,1210638,7415589.95 ,455972
20140207,4061,4083,4130,4131,4078,4096,4094,13,11,412980,2536354.27 ,414250
20140210,4096,4094,4100,4153,4080,4149,4110,55,16,1950536,12027413.96 ,540492
20140211,4149,4110,4168,4176,4122,4133,4148,23,38,1735816,10800543.42 ,533038
20140212,4133,4148,4150,4154,4103,4135,4128,-13,-20,2295082,14213599.04 ,522826
20140213,4135,4128,4150,4157,4129,4136,4142,8,14,1665284,10348848.17 ,529180
20140214,4136,4142,4144,4250,4135,4249,4189,107,47,2480476,15586218.04 ,656584
20140217,4249,4189,4305,4440,4285,4440,4354,251,165,2727756,17815701.36 ,687998
20140218,4440,4354,4441,4483,4384,4412,4438,58,84,3059920,20370183.70 ,668884
20140219,4412,4438,4399,4469,4385,4432,4431,-6,-7,3714632,24690679.49 ,705584
20140220,4432,4431,4439,4462,4353,4388,4420,-43,-11,3578102,23725851.16 ,665272
20140221,4388,4420,4383,4421,4371,4394,4399,-26,-21,2749468,18144777.08 ,648202
20140224,4394,4399,4407,4425,4333,4408,4396,9,-3,3120350,20578614.92 ,638146
20140225,4408,4396,4450,4461,4405,4409,4436,13,40,3345578,22262421.57 ,624978
20140226,4409,4436,4400,4468,4383,4441,4417,5,-19,3540346,23460631.43 ,658932
20140227,4441,4417,4387,4387,4251,4283,4329,-134,-88,4259772,27667081.13 ,519400
20140228,4283,4329,4305,4325,4272,4282,4294,-47,-35,3056448,19688573.37 ,520868
20140303,4282,4294,4296,4350,4275,4334,4308,40,14,2660878,17196858.83 ,512046
20140304,4334,4308,4325,4357,4281,4288,4331,-20,23,2896910,18820780.02 ,523980
20140305,4288,4331,4270,4304,4262,4287,4280,-44,-51,2443770,15690686.71 ,508548
20140306,4287,4280,4287,4304,4266,4282,4288,2,8,1893578,12182105.45 ,500426
20140307,4282,4288,4278,4354,4275,4332,4311,44,23,2508262,16222504.22 ,490464
20140310,4332,4311,4305,4322,4138,4165,4212,-146,-99,3954986,24989211.79 ,500478
20140311,4165,4212,4193,4229,4170,4194,4191,-18,-21,2024496,12727807.57 ,450194
20140312,4194,4191,4234,4266,4150,4234,4211,43,20,3141810,19848846.08 ,438114
20140313,4234,4211,4241,4317,4229,4275,4268,64,57,2800848,17934115.77 ,451802
20140314,4275,4268,4246,4286,4240,4269,4265,1,-3,2155606,13791097.57 ,432938
20140317,4269,4265,4365,4388,4269,4306,4324,41,59,2785618,18068536.42 ,443654
20140318,4306,4324,4299,4308,4221,4244,4271,-80,-53,2231534,14297893.62 ,450540
20140319,4244,4271,4160,4231,4156,4211,4198,-60,-73,2067478,13019958.51 ,454298
20140320,4211,4198,4186,4247,4164,4192,4198,-6,0,3038494,19136601.98 ,417624
20140321,4192,4198,4135,4191,4131,4170,4168,-28,-30,1831372,11450302.95 ,404796
20140324,4170,4168,4185,4196,4138,4152,4171,-16,3,1428226,8937675.56 ,421680
20140325,4152,4171,4147,4153,4110,4141,4133,-30,-38,1826138,11323390.46 ,452282
20140326,4141,4133,4138,4165,4126,4164,4147,31,14,1562460,9720224.93 ,450210
20140327,4164,4147,4150,4155,4102,4128,4134,-19,-13,1823344,11307206.05 ,455770
20140328,4128,4134,4122,4144,4112,4139,4127,5,-7,1343874,8319998.00 ,446894
20140331,4139,4127,4134,4158,4121,4128,4141,1,14,1328368,8252187.77 ,439028
20140401,4128,4141,4131,4146,4091,4117,4126,-24,-15,1288606,7975633.11 ,445658
20140402,4117,4126,4122,4129,4110,4125,4121,-1,-5,906920,5606521.13 ,438552
20140403,4125,4121,4145,4148,4120,4139,4136,18,15,989192,6138318.64 ,424480
20140404,4139,4136,4116,4126,4112,4121,4119,-15,-17,742022,4585037.00 ,417046
20140408,4121,4119,4127,4170,4121,4164,4148,45,29,510158,3174695.25 ,441038
20140409,4164,4148,4170,4177,4151,4155,4166,7,18,882738,5516376.17 ,460368
20140410,4155,4166,4100,4170,4099,4157,4133,-9,-33,1072752,6651526.13 ,433342
20140411,4157,4133,4174,4176,4142,4148,4162,15,29,997636,6229285.31 ,445700
20140414,4148,4162,4148,4170,4145,4166,4155,4,-7,806212,5025777.81 ,445256
20140415,4166,4155,4151,4167,4107,4109,4142,-46,-13,1041368,6470679.05 ,519606
20140416,4109,4142,4050,4078,4037,4064,4062,-78,-80,1509138,9196173.79 ,530132
20140417,4064,4062,4082,4084,4051,4057,4069,-5,7,965550,5894427.21 ,520278
20140418,4057,4069,4064,4068,4042,4051,4058,-18,-11,643384,3917192.85 ,473128
20140421,4051,4058,4051,4059,3972,3990,4007,-68,-51,853788,5131929.26 ,512168
20140422,3990,4007,4001,4024,3980,4011,3998,4,-9,979376,5873821.77 ,465820
20140423,4011,3998,4009,4035,3996,4017,4010,19,12,941766,5665466.55 ,448592
20140424,4017,4010,4016,4031,4007,4028,4018,18,8,644956,3887416.58 ,421470
20140425,4028,4018,3996,4177,3993,4070,4075,52,57,2221006,13578141.34 ,383052
20140428,4070,4075,4085,4120,4079,4104,4103,29,28,1450404,8926703.79 ,372322
20140429,4104,4103,4117,4118,4075,4076,4091,-27,-12,1101274,6759156.23 ,367922
20140430,4076,4091,4080,4091,4055,4065,4077,-26,-14,758010,4636602.51 ,312166
20140505,4065,4077,4083,4108,4070,4096,4091,19,14,250258,1535811.83 ,285118
20140506,4096,4091,4108,4113,4077,4097,4097,6,6,560348,3443686.90 ,285340
20140507,4097,4097,4101,4108,4093,4102,4099,5,2,479156,2946341.28 ,264616
20140508,4102,4099,4089,4092,4040,4055,4063,-44,-36,773628,4715796.58 ,280466
20140509,4055,4063,4045,4063,4030,4056,4047,-7,-16,531224,3225130.68 ,266262
20140512,4056,4047,4056,4091,4047,4087,4063,40,16,595978,3632758.51 ,255388
20140513,4087,4063,4112,4126,4086,4098,4112,35,49,428242,2641681.86 ,239240
20140514,4098,4112,4108,4118,4096,4117,4107,5,-5,192232,1184383.43 ,229894
20140515,4117,4107,4161,4168,4129,4132,4141,25,34,227652,1414348.54 ,215118
20140516,4132,4141,4115,4123,4099,4100,4115,-41,-26,181508,1120382.26 ,203842
20140519,4100,4115,4098,4136,4094,4133,4113,18,-2,162122,1000321.61 ,193742
20140520,4133,4113,4141,4143,4106,4114,4122,1,9,123304,762443.00 ,181306
20140521,4114,4122,4109,4140,4103,4129,4126,7,4,132138,817957.83 ,170572
20140522,4129,4126,4116,4149,4114,4146,4130,20,4,103222,639467.09 ,166450
20140523,4146,4130,4158,4161,4126,4142,4142,12,12,94090,584627.47 ,153060
20140526,4142,4142,4136,4149,4135,4143,4142,1,0,59862,371935.10 ,147722
20140527,4143,4142,4141,4147,4118,4120,4134,-22,-8,54522,338120.35 ,136276
20140528,4120,4134,4100,4138,4098,4130,4119,-4,-15,93800,579563.87 ,113854
20140529,4130,4119,4132,4164,4125,4128,4144,9,25,110406,686306.92 ,93414
20140530,4128,4144,4121,4153,4104,4119,4131,-25,-13,86110,533600.86 ,71314
20140603,4119,4131,4098,4120,4085,4108,4105,-23,-26,17610,108442.37 ,67208
20140604,4108,4105,4105,4107,4090,4098,4095,-7,-10,16500,101352.09 ,67176
20140605,4098,4095,4104,4104,4053,4062,4068,-33,-27,24696,150714.70 ,54628
20140606,4062,4068,4076,4095,4066,4076,4074,8,6,18344,112101.08 ,43700
20140609,4076,4074,4075,4080,4057,4070,4067,-4,-7,7536,45982.64 ,39840
20140610,4070,4067,4073,4076,4059,4065,4071,-2,4,30300,185064.64 ,14200
20140611,4065,4071,4072,4080,4069,4071,4074,0,3,7696,47030.63 ,8544
20140612,4071,4074,4073,4078,4051,4052,4060,-22,-14,2924,17807.50 ,6592
20140613,4052,4060,4119,4119,4092,4106,4102,46,42,1084,6670.58 ,6064
20140616,4106,4102,4120,4160,4081,4160,4127,58,25,684,4235.08 ,6112
20140102,4110,4146,4148,4221,4148,4214,4207,68,61,92,580.66 ,514
20140103,4214,4207,4203,4235,4185,4214,4203,7,-4,196,1235.76 ,578
20140106,4214,4203,4202,4250,4192,4201,4217,-2,14,364,2302.96 ,486
20140107,4201,4217,4196,4222,4193,4202,4208,-15,-9,52,328.25 ,474
20140108,4202,4208,4165,4168,4111,4111,4133,-97,-75,50,310.05 ,474
20140109,4111,4133,4114,4115,4024,4052,4057,-81,-76,156,949.34 ,482
20140110,4052,4057,4080,4117,4035,4090,4083,33,26,112,686.05 ,480
20140113,4090,4083,4091,4201,4068,4168,4148,85,65,214,1331.77 ,540
20140114,4168,4148,4124,4202,4107,4187,4152,39,4,318,1980.61 ,540
20140115,4187,4152,4170,4212,4149,4160,4173,8,21,64,400.62 ,524
20140116,4160,4173,4132,4170,4132,4146,4151,-27,-22,48,298.89 ,514
20140117,4146,4151,4156,4159,4145,4149,4152,-2,1,54,336.34 ,514
20140120,4149,4152,4160,4188,4160,4184,4177,32,25,40,250.66 ,510
20140121,4184,4177,4185,4193,4156,4161,4167,-16,-10,36,225.03 ,508
20140122,4161,4167,4114,4121,4086,4102,4104,-65,-63,90,554.17 ,504
20140123,4102,4104,4105,4109,4067,4084,4083,-20,-21,132,808.52 ,492
20140124,4084,4083,4131,4155,4120,4131,4139,48,56,136,844.51 ,488
20140127,4131,4139,4158,4158,4090,4112,4117,-27,-22,290,1790.93 ,484
20140128,4112,4117,4089,4114,4089,4112,4105,-5,-12,70,431.03 ,482
20140129,4112,4105,4104,4112,4080,4096,4098,-9,-7,134,823.77 ,486
20140130,4096,4098,4106,4114,4058,4065,4086,-33,-12,212,1299.35 ,484
20140207,4065,4086,4099,4109,4090,4105,4102,19,16,180,1107.79 ,544
20140210,4105,4102,4105,4160,4103,4160,4122,58,20,124,766.79 ,576
20140211,4160,4122,4174,4175,4136,4136,4152,14,30,86,535.72 ,584
20140212,4136,4152,4152,4152,4118,4143,4135,-9,-17,78,483.91 ,602
20140213,4143,4135,4164,4164,4145,4147,4151,12,16,42,261.55 ,606
20140214,4147,4151,4151,4254,4151,4254,4219,103,68,116,734.14 ,600
20140217,4254,4219,4300,4472,4285,4450,4438,231,219,552,3675.40 ,848
20140218,4450,4438,4447,4493,4398,4415,4448,-23,10,736,4911.23 ,814
20140219,4415,4448,4395,4512,4395,4461,4433,13,-15,316,2101.58 ,772
20140220,4461,4433,4420,4459,4372,4395,4407,-38,-26,232,1533.66 ,778
20140221,4395,4407,4400,4424,4387,4406,4408,-1,1,256,1692.96 ,766
20140224,4406,4408,4413,4435,4355,4410,4377,2,-31,824,5410.08 ,758
20140225,4410,4377,4550,4550,4420,4422,4445,45,68,338,2253.73 ,776
20140226,4422,4445,4418,4470,4398,4470,4424,25,-21,236,1566.23 ,824
20140227,4470,4424,4390,4404,4265,4294,4333,-130,-91,224,1456.08 ,854
20140228,4294,4333,4311,4334,4290,4300,4304,-33,-29,136,878.14 ,868
20140303,4300,4304,4311,4362,4295,4348,4333,44,29,194,1261.03 ,832
20140304,4348,4333,4337,4365,4307,4309,4337,-24,4,214,1392.42 ,822
20140305,4309,4337,4288,4315,4277,4304,4300,-33,-37,204,1315.97 ,820
20140306,4304,4300,4316,4316,4282,4288,4301,-12,1,206,1329.22 ,750
20140307,4288,4301,4301,4361,4301,4335,4338,34,37,82,533.66 ,750
20140310,4335,4338,4349,4349,4159,4176,4207,-162,-131,512,3231.67 ,746
20140311,4176,4207,4201,4234,4185,4211,4205,4,-2,142,895.72 ,732
20140312,4211,4205,4242,4275,4171,4250,4216,45,11,184,1163.69 ,756
20140313,4250,4216,4263,4326,4248,4283,4299,67,83,188,1212.34 ,754
20140314,4283,4299,4270,4294,4262,4281,4279,-18,-20,126,808.85 ,760
20140317,4281,4279,4383,4395,4286,4319,4324,40,45,224,1453.11 ,740
20140318,4319,4324,4309,4309,4238,4252,4267,-72,-57,214,1369.83 ,718
20140319,4252,4267,4196,4240,4196,4218,4219,-49,-48,226,1430.42 ,712
20140320,4218,4219,4203,4260,4179,4204,4189,-15,-30,1002,6296.52 ,754
20140321,4204,4189,4173,4200,4173,4183,4183,-6,-6,552,3463.73 ,746
20140324,4183,4183,4198,4205,4155,4170,4182,-13,-1,1250,7842.66 ,880
20140325,4170,4182,4155,4164,4110,4156,4131,-26,-51,790,4895.89 ,812
20140326,4156,4131,4158,4176,4140,4169,4161,38,30,94,586.77 ,818
20140327,4169,4161,4160,4162,4120,4152,4145,-9,-16,160,995.00 ,836
20140328,4152,4145,4137,4150,4130,4148,4142,3,-3,164,1019.00 ,852
20140331,4148,4142,4144,4168,4142,4142,4155,0,13,132,822.81 ,830
20140401,4142,4155,4147,4149,4116,4116,4141,-39,-14,48,298.17 ,816
20140402,4116,4141,4139,4139,4125,4133,4131,-8,-10,42,260.31 ,804
20140403,4133,4131,4150,4158,4138,4150,4148,19,17,60,373.32 ,806
20140404,4150,4148,4141,4141,4127,4130,4131,-18,-17,108,669.25 ,822
20140408,4130,4131,4150,4179,4145,4179,4163,48,32,82,512.16 ,830
20140409,4179,4163,4169,4185,4165,4167,4179,4,16,192,1203.77 ,820
20140410,4167,4179,4122,4176,4122,4164,4152,-15,-27,88,548.08 ,816
20140411,4164,4152,4183,4184,4155,4164,4171,12,19,86,538.15 ,802
20140414,4164,4171,4163,4172,4156,4170,4167,-1,-4,106,662.71 ,800
20140415,4170,4167,4170,4170,4121,4125,4145,-42,-22,76,472.57 ,808
20140416,4125,4145,4040,4086,4040,4075,4068,-70,-77,100,610.29 ,818
20140417,4075,4068,4082,4092,4063,4071,4079,3,11,214,1309.47 ,844
20140418,4071,4079,4075,4077,4057,4062,4066,-17,-13,116,707.55 ,848
20140421,4062,4066,4062,4065,3981,3991,3996,-75,-70,352,2110.27 ,888
20140422,3991,3996,3996,4017,3983,4011,3999,15,3,1162,6970.64 ,912
20140423,4011,3999,4010,4034,4001,4019,4013,20,14,192,1155.89 ,898
20140424,4019,4013,4024,4031,4017,4024,4021,11,8,252,1520.24 ,966
20140425,4024,4021,4013,4130,4005,4079,4077,58,56,2736,16735.89 ,1086
20140428,4079,4077,4090,4121,4090,4107,4103,30,26,466,2868.04 ,1076
20140429,4107,4103,4118,4118,4080,4080,4094,-23,-9,286,1756.59 ,1164
20140430,4080,4094,4079,4088,4058,4058,4073,-36,-21,102,623.29 ,1160
20140505,4058,4073,4099,4102,4087,4102,4099,29,26,1056,6493.11 ,1830
20140506,4102,4099,4105,4118,4086,4094,4100,-5,1,208,1279.47 ,1774
20140507,4094,4100,4099,4112,4097,4100,4101,0,1,614,3777.84 ,1448
20140508,4100,4101,4077,4077,4044,4055,4055,-46,-46,458,2785.85 ,1396
20140509,4055,4055,4046,4056,4035,4056,4041,1,-14,336,2036.76 ,1262
20140512,4056,4041,4052,4088,4040,4084,4059,43,18,400,2435.75 ,1290
20140513,4084,4059,4116,4121,4083,4091,4104,32,45,456,2807.42 ,1326
20140514,4091,4104,4096,4108,4095,4108,4102,4,-2,118,726.19 ,1282
20140515,4108,4102,4163,4182,4126,4130,4138,28,36,554,3438.98 ,1152
20140516,4130,4138,4113,4120,4088,4088,4108,-50,-30,470,2896.55 ,1122
20140519,4088,4108,4084,4123,4081,4118,4092,10,-16,666,4088.57 ,1348
20140520,4118,4092,4122,4125,4091,4100,4103,8,11,190,1169.61 ,1386
20140521,4100,4103,4089,4127,4085,4120,4117,17,14,200,1235.19 ,1352
20140522,4120,4117,4109,4123,4109,4120,4118,3,1,96,593.10 ,1400
20140523,4120,4118,4137,4143,4110,4128,4122,10,4,270,1669.71 ,1384
20140526,4128,4122,4128,4131,4120,4125,4127,3,5,418,2587.81 ,1390
20140527,4125,4127,4133,4133,4102,4106,4117,-21,-10,502,3100.72 ,1388
20140528,4106,4117,4090,4115,4077,4115,4087,-2,-30,524,3212.61 ,1554
20140529,4115,4087,4091,4118,4090,4090,4101,3,14,1340,8244.64 ,1806
20140530,4090,4101,4098,4115,4079,4098,4096,-3,-5,614,3772.94 ,1574
20140603,4098,4096,4041,4088,4039,4070,4073,-26,-23,278,1698.76 ,1676
20140604,4070,4073,4074,4079,4055,4075,4070,2,-3,390,2381.05 ,1640
20140605,4075,4070,4060,4086,4049,4054,4065,-16,-5,380,2317.39 ,1698
20140606,4054,4065,4078,4081,4065,4067,4070,2,5,462,2820.63 ,1674
20140609,4067,4070,4087,4087,4042,4058,4057,-12,-13,722,4394.38 ,1622
20140610,4058,4057,4058,4059,4043,4047,4053,-10,-4,206,1252.55 ,1724
20140611,4047,4053,4067,4072,4055,4072,4066,19,13,364,2220.20 ,1724
20140612,4072,4066,4072,4072,4050,4060,4056,-6,-10,328,1995.86 ,1718
20140613,4060,4056,4067,4119,4067,4119,4099,63,43,96,590.38 ,1760
20140616,4119,4099,4100,4173,4100,4150,4143,51,44,346,2150.28 ,1870
20140617,4150,4143,4135,4135,4097,4097,4113,-46,-30,260,1604.31 ,1736
20140618,4097,4113,4113,4129,4110,4110,4124,-3,11,56,346.49 ,1738
20140619,4110,4124,4119,4162,4119,4150,4144,26,20,160,994.75 ,1706
20140620,4150,4144,4250,4358,4143,4310,4261,166,117,1008,6443.42 ,1730
20140623,4310,4261,4317,4358,4300,4322,4319,61,58,1844,11948.03 ,2116
20140624,4322,4319,4322,4327,4299,4319,4310,0,-9,348,2250.12 ,2094
20140625,4319,4310,4344,4344,4258,4285,4299,-25,-11,194,1251.17 ,2000
20140626,4285,4299,4293,4300,4268,4282,4287,-17,-12,1338,8604.41 ,2500
20140627,4282,4287,4284,4330,4280,4280,4299,-7,12,192,1238.12 ,2350
20140630,4280,4299,4280,4288,4259,4288,4270,-11,-29,162,1037.81 ,2212
20140701,4288,4270,4245,4290,4245,4285,4286,15,16,116,745.87 ,2200
20140702,4285,4286,4281,4324,4261,4290,4285,4,-1,260,1671.20 ,2176
20140703,4290,4285,4290,4325,4285,4285,4310,0,25,140,905.28 ,2064
20140704,4285,4310,4299,4320,4299,4320,4306,10,-4,336,2170.51 ,2064
20140707,4320,4306,4231,4301,4230,4261,4273,-45,-33,1032,6614.64 ,2176
20140708,4261,4273,4243,4297,4240,4297,4276,24,3,396,2540.19 ,1940
20140709,4297,4276,4289,4290,4287,4289,4288,13,12,68,437.46 ,1940
20140710,4289,4288,4236,4390,4235,4300,4320,12,32,248,1607.37 ,1884
20140711,4300,4320,4335,4388,4335,4380,4375,60,55,232,1522.55 ,1884
20140714,4380,4375,4400,4400,4340,4340,4346,-35,-29,320,2086.25 ,2108
20140715,4340,4346,4320,4330,4320,4330,4320,-16,-26,120,777.72 ,2228
20140102,4119,4138,4199,4227,4199,4227,4218,89,80,26,164.54 ,330
20140103,4227,4218,4196,4227,4196,4219,4219,1,1,150,949.43 ,424
20140106,4219,4219,4211,4237,4211,4237,4224,18,5,4,25.34 ,424
20140107,4237,4224,4204,4218,4204,4218,4212,-6,-12,50,315.91 ,424
20140108,4218,4212,4166,4172,4101,4101,4137,-111,-75,28,173.77 ,426
20140109,4101,4137,4114,4124,4040,4051,4057,-86,-80,1268,7717.33 ,422
20140110,4051,4057,4066,4115,4049,4115,4070,58,13,76,464.09 ,408
20140113,4115,4070,4104,4207,4078,4183,4130,113,60,112,693.95 ,410
20140114,4183,4130,4140,4204,4140,4204,4179,74,49,6,37.62 ,410
20140115,4204,4179,4191,4195,4159,4159,4186,-20,7,16,100.48 ,402
20140116,4159,4186,4135,4163,4135,4156,4148,-30,-38,20,124.46 ,404
20140117,4156,4148,4164,4164,4164,4164,4164,16,16,4,24.98 ,400
20140120,4164,4164,4189,4189,4189,4189,4189,25,25,2,12.57 ,398
20140121,4189,4189,4170,4171,4170,4170,4170,-19,-19,18,112.60 ,392
20140122,4170,4170,4138,4138,4116,4120,4120,-50,-50,20,123.61 ,392
20140123,4120,4120,4117,4117,4079,4080,4092,-40,-28,68,417.46 ,398
20140124,4080,4092,4141,4154,4136,4143,4144,51,52,76,472.47 ,382
20140127,4143,4144,4126,4134,4122,4122,4127,-22,-17,46,284.80 ,370
20140128,4122,4127,4112,4120,4108,4117,4112,-10,-15,84,518.20 ,370
20140129,4117,4112,4109,4113,4088,4099,4104,-13,-8,104,640.24 ,408
20140130,4099,4104,4100,4103,4064,4079,4080,-25,-24,104,636.54 ,436
20140207,4079,4080,4108,4121,4099,4115,4113,35,33,466,2875.29 ,530
20140210,4115,4113,4119,4163,4119,4163,4136,50,23,128,794.17 ,558
20140211,4163,4136,4171,4171,4153,4154,4161,18,25,52,324.56 ,570
20140212,4154,4161,4148,4153,4137,4152,4148,-9,-13,40,248.89 ,566
20140213,4152,4148,4152,4152,4151,4151,4151,3,3,12,74.73 ,566
20140214,4151,4151,4185,4255,4185,4248,4241,97,90,36,229.03 ,562
20140217,4248,4241,4325,4495,4325,4488,4456,247,215,112,748.71 ,598
20140218,4488,4456,4433,4504,4406,4429,4449,-27,-7,206,1375.01 ,606
20140219,4429,4449,4429,4480,4425,4445,4458,-4,9,108,722.34 ,604
20140220,4445,4458,4473,4473,4382,4408,4431,-50,-27,72,478.62 ,604
20140221,4408,4431,4427,4429,4397,4413,4415,-18,-16,50,331.19 ,614
20140224,4413,4415,4426,4426,4363,4402,4389,-13,-26,192,1264.27 ,568
20140225,4402,4389,4466,4466,4428,4435,4441,46,52,100,666.20 ,558
20140226,4435,4441,4422,4476,4408,4472,4432,31,-9,126,837.82 ,530
20140227,4472,4432,4385,4392,4285,4297,4327,-135,-105,100,649.13 ,552
20140228,4297,4327,4314,4328,4307,4314,4318,-13,-9,108,699.55 ,572
20140303,4314,4318,4325,4375,4325,4359,4359,41,41,74,483.90 ,572
20140304,4359,4359,4357,4375,4310,4313,4353,-46,-6,98,639.91 ,590
20140305,4313,4353,4307,4323,4288,4308,4311,-45,-42,126,814.94 ,580
20140306,4308,4311,4325,4325,4302,4311,4311,0,0,30,194.00 ,582
20140307,4311,4311,4365,4365,4347,4347,4354,36,43,52,339.66 ,576
20140310,4347,4354,4329,4329,4174,4176,4223,-178,-131,228,1444.34 ,600
20140311,4176,4223,4204,4250,4200,4237,4211,14,-12,74,467.45 ,594
20140312,4237,4211,4257,4290,4185,4274,4241,63,30,76,483.50 ,604
20140313,4274,4241,4261,4331,4261,4300,4303,59,62,134,864.96 ,602
20140314,4300,4303,4284,4302,4284,4291,4294,-12,-9,38,244.80 ,608
20140317,4291,4294,4409,4409,4300,4327,4338,33,44,86,559.63 ,624
20140318,4327,4338,4314,4315,4248,4266,4270,-72,-68,98,627.80 ,632
20140319,4266,4270,4200,4242,4200,4228,4230,-42,-40,100,634.52 ,630
20140320,4228,4230,4207,4264,4196,4216,4225,-14,-5,86,545.05 ,630
20140321,4216,4225,4199,4205,4177,4197,4193,-28,-32,128,805.19 ,614
20140324,4197,4193,4201,4214,4170,4170,4201,-23,8,58,365.53 ,620
20140325,4170,4201,4173,4173,4141,4154,4154,-47,-47,44,274.22 ,630
20140326,4154,4154,4163,4177,4152,4174,4166,20,12,26,162.48 ,624
20140327,4174,4166,4164,4164,4130,4138,4148,-28,-18,14,87.11 ,616
20140328,4138,4148,4140,4160,4140,4160,4150,12,2,22,136.97 ,622
20140331,4160,4150,4170,4170,4149,4149,4156,-1,6,16,99.76 ,614
20140401,4149,4156,4148,4156,4118,4118,4146,-38,-10,24,149.27 ,602
20140402,4118,4146,4120,4147,4120,4139,4140,-7,-6,28,173.88 ,600
20140403,4139,4140,4160,4160,4150,4152,4154,12,14,12,74.79 ,598
20140404,4152,4154,,,,4154,4154,0,0,0,0.00 ,598
20140408,4154,4154,4173,4184,4173,4184,4179,30,25,6,37.61 ,602
20140409,4184,4179,4189,4192,4180,4191,4188,12,9,12,75.38 ,600
20140410,4191,4188,4140,4176,4140,4175,4161,-13,-27,10,62.42 ,598
20140411,4175,4161,4185,4194,4173,4182,4183,21,22,14,87.86 ,602
20140414,4182,4183,4176,4176,4170,4176,4175,-7,-8,14,87.68 ,594
20140415,4176,4175,4173,4182,4135,4135,4161,-40,-14,24,149.80 ,592
20140416,4135,4161,4066,4085,4066,4085,4072,-76,-89,20,122.19 ,604
20140417,4085,4072,4095,4102,4070,4075,4080,3,8,52,318.24 ,618
20140418,4075,4080,4080,4080,4060,4064,4068,-16,-12,54,329.59 ,640
20140421,4064,4068,4057,4069,4000,4007,4028,-61,-40,106,640.58 ,676
20140422,4007,4028,4002,4030,4000,4026,4007,-2,-21,60,360.64 ,672
20140423,4026,4007,4009,4037,4009,4024,4024,17,17,20,120.74 ,672
20140424,4024,4024,,,,4030,4030,6,6,0,0.00 ,672
20140425,4030,4030,4023,4162,4023,4082,4083,52,53,146,894.26 ,700
20140428,4082,4083,4117,4125,4109,4109,4117,26,34,106,654.62 ,708
20140429,4109,4117,4089,4104,4089,4096,4096,-21,-21,42,258.06 ,704
20140430,4096,4096,4092,4092,4063,4063,4076,-33,-20,72,440.28 ,744
20140505,4063,4076,4100,4100,4088,4095,4092,19,16,46,282.41 ,738
20140506,4095,4092,4091,4091,4091,4091,4091,-1,-1,2,12.27 ,738
20140507,4091,4091,4103,4103,4102,4102,4102,11,11,4,24.62 ,740
20140508,4102,4102,4094,4094,4043,4050,4052,-52,-50,114,693.02 ,756
20140509,4050,4052,4047,4056,4033,4052,4046,0,-6,56,339.87 ,760
20140512,4052,4046,4034,4093,4034,4089,4068,43,22,146,890.91 ,772
20140513,4089,4068,4115,4120,4080,4088,4111,20,43,66,407.03 ,764
20140514,4088,4111,4099,4104,4094,4104,4098,-7,-13,10,61.47 ,762
20140515,4104,4098,4161,4163,4125,4136,4147,38,49,276,1717.19 ,936
20140516,4136,4147,4114,4114,4088,4088,4096,-59,-51,82,503.93 ,928
20140519,4088,4096,4081,4110,4066,4106,4092,10,-4,182,1117.31 ,850
20140520,4106,4092,4111,4111,4080,4095,4094,3,2,156,958.06 ,876
20140521,4095,4094,4079,4120,4075,4120,4103,26,9,84,517.00 ,868
20140522,4120,4103,4089,4124,4089,4115,4113,12,10,116,715.82 ,860
20140523,4115,4113,4134,4134,4110,4110,4118,-3,5,12,74.14 ,854
20140526,4110,4118,4128,4128,4115,4125,4124,7,6,52,321.68 ,892
20140527,4125,4124,4121,4125,4100,4100,4118,-24,-6,76,469.50 ,848
20140528,4100,4118,4021,4109,4021,4084,4072,-34,-46,350,2137.92 ,874
20140529,4084,4072,4092,4092,4051,4055,4076,-17,4,408,2494.88 ,950
20140530,4055,4076,4055,4076,4053,4068,4064,-8,-12,210,1280.29 ,970
20140603,4068,4064,4040,4068,4039,4064,4053,0,-11,56,340.50 ,960
20140604,4064,4053,4054,4069,4053,4065,4057,12,4,112,681.68 ,906
20140605,4065,4057,4071,4077,4045,4045,4055,-12,-2,222,1350.56 ,952
20140606,4045,4055,4065,4076,4055,4071,4066,16,11,206,1256.49 ,1008
20140609,4071,4066,4078,4078,4033,4046,4049,-20,-17,62,376.61 ,1028
20140610,4046,4049,4055,4055,4047,4047,4051,-2,2,14,85.08 ,1026
20140611,4047,4051,4065,4068,4058,4067,4064,16,13,196,1194.82 ,1100
20140612,4067,4064,4071,4071,4051,4055,4059,-9,-5,116,706.40 ,1116
20140613,4055,4059,4059,4121,4059,4084,4092,25,33,150,920.77 ,1150
20140616,4084,4092,4142,4156,4142,4154,4148,62,56,278,1730.01 ,1098
20140617,4154,4148,4141,4141,4116,4116,4123,-32,-25,70,432.98 ,1108
20140618,4116,4123,4104,4134,4104,4115,4120,-8,-3,138,852.90 ,1018
20140619,4115,4120,4140,4159,4130,4139,4144,19,24,54,335.71 ,1036
20140620,4139,4144,4178,4320,4178,4310,4243,166,99,614,3908.49 ,1162
20140623,4310,4243,4310,4355,4306,4331,4330,88,87,206,1338.25 ,1138
20140624,4331,4330,4313,4313,4303,4305,4305,-25,-25,50,322.93 ,1140
20140625,4305,4305,4341,4347,4269,4291,4315,-14,10,130,841.47 ,1086
20140626,4291,4315,4301,4317,4301,4301,4304,-14,-11,72,464.89 ,1044
20140627,4301,4304,4313,4344,4300,4344,4316,40,12,142,919.46 ,990
20140630,4344,4316,4320,4320,4278,4296,4292,-20,-24,112,721.10 ,896
20140701,4296,4292,4291,4325,4281,4317,4319,25,27,110,712.65 ,916
20140702,4317,4319,4321,4323,4300,4317,4306,-2,-13,40,258.41 ,888
20140703,4317,4306,4318,4354,4297,4297,4312,-9,6,106,685.61 ,832
20140704,4297,4312,4306,4332,4305,4330,4318,18,6,254,1645.47 ,638
20140707,4330,4318,4324,4324,4267,4274,4293,-44,-25,80,515.16 ,616
20140708,4274,4293,4467,4467,4238,4293,4292,0,-1,70,450.67 ,564
20140709,4293,4292,4313,4313,4280,4300,4298,8,6,38,245.00 ,560
20140710,4300,4298,4290,4345,4290,4333,4330,35,32,44,285.81 ,526
20140711,4333,4330,4303,4408,4302,4405,4379,75,49,140,919.61 ,480
20140714,4405,4379,4397,4405,4346,4346,4378,-33,-1,128,840.71 ,448
20140715,4346,4378,4316,4323,4310,4312,4313,-66,-65,50,323.54 ,466
20140716,4312,4313,4322,4322,4283,4293,4294,-20,-19,528,3401.35 ,852
20140717,4293,4294,4312,4325,4297,4315,4314,21,20,136,880.22 ,910
20140718,4315,4314,4310,4365,4310,4338,4350,24,36,366,2388.51 ,936
20140721,4338,4350,4312,4329,4300,4329,4308,-21,-42,158,1021.15 ,866
20140722,4329,4308,4328,4340,4315,4323,4322,15,14,182,1179.98 ,1028
20140723,4323,4322,4344,4352,4330,4340,4340,18,18,462,3007.96 ,1272
20140724,4340,4340,4317,4322,4303,4303,4313,-37,-27,72,465.90 ,1256
20140725,4303,4313,4277,4283,4248,4283,4274,-30,-39,56,359.09 ,1278
20140728,4283,4274,4321,4351,4245,4299,4302,25,28,32,206.50 ,1274
20140729,4299,4302,4201,4295,4201,4295,4252,-7,-50,300,1913.71 ,1318
20140730,4295,4252,4312,4312,4263,4292,4282,40,30,126,809.33 ,1318
20140731,4292,4282,4285,4307,4266,4299,4287,17,5,60,385.91 ,1304
20140801,4299,4287,4280,4290,4277,4290,4283,3,-4,160,1027.99 ,1412
20140804,4290,4283,,,,4283,4283,0,0,0,0.00 ,1412
20140805,4283,4283,4273,4317,4273,4273,4280,-10,-3,28,179.80 ,1424
20140806,4273,4280,4244,4259,4226,4243,4243,-37,-37,384,2444.50 ,1280
20140807,4243,4243,4256,4270,4256,4270,4268,27,25,32,204.86 ,1288
20140808,4270,4268,4257,4297,4248,4297,4280,29,12,136,873.13 ,1324
20140811,4297,4280,4260,4283,4242,4242,4265,-38,-15,160,1023.77 ,1240
20140812,4242,4265,4261,4275,4250,4270,4261,5,-4,336,2147.89 ,1236
20140813,4270,4261,4271,4271,4269,4269,4269,8,8,24,153.70 ,1256
20140814,4269,4269,4250,4250,4250,4250,4250,-19,-19,68,433.50 ,1324
20140815,4250,4250,4280,4280,4220,4250,4257,0,7,376,2401.49 ,1208
20140102,4121,4129,4155,4239,4155,4230,4211,101,82,108,682.21 ,626
20140103,4230,4211,4203,4239,4203,4233,4218,22,7,88,556.87 ,596
20140106,4233,4218,4211,4216,4206,4215,4213,-3,-5,26,164.33 ,588
20140107,4215,4213,4217,4226,4212,4212,4220,-1,7,42,265.89 ,584
20140108,4212,4220,4126,4140,4107,4107,4124,-113,-96,190,1175.39 ,640
20140109,4107,4124,4151,4155,4050,4075,4101,-49,-23,250,1538.08 ,604
20140110,4075,4101,4078,4126,4050,4115,4094,14,-7,68,417.63 ,572
20140113,4115,4094,4112,4269,4081,4188,4160,94,66,112,698.89 ,556
20140114,4188,4160,4137,4214,4125,4208,4190,48,30,340,2137.35 ,626
20140115,4208,4190,4182,4207,4158,4168,4172,-22,-18,62,388.05 ,604
20140116,4168,4172,4155,4183,4137,4162,4167,-10,-5,86,537.64 ,578
20140117,4162,4167,4158,4177,4158,4167,4171,0,4,20,125.14 ,572
20140120,4167,4171,4173,4210,4173,4198,4193,27,22,56,352.25 ,584
20140121,4198,4193,4196,4196,4171,4171,4178,-22,-15,42,263.24 ,574
20140122,4171,4178,4133,4133,4112,4117,4127,-61,-51,30,185.72 ,570
20140123,4117,4127,4102,4102,4080,4097,4092,-30,-35,36,221.02 ,574
20140124,4097,4092,4155,4171,4138,4147,4151,55,59,26,161.91 ,572
20140127,4147,4151,4173,4173,4108,4130,4127,-21,-24,34,210.49 ,578
20140128,4130,4127,4120,4140,4120,4122,4122,-5,-5,16,98.95 ,580
20140129,4122,4122,4115,4126,4102,4103,4116,-19,-6,166,1024.99 ,622
20140130,4103,4116,4125,4125,4075,4083,4093,-33,-23,26,159.63 ,626
20140207,4083,4093,4110,4123,4110,4118,4117,25,24,38,234.67 ,616
20140210,4118,4117,4137,4174,4122,4174,4150,57,33,22,136.97 ,630
20140211,4174,4150,4154,4204,4153,4153,4178,3,28,148,927.56 ,642
20140212,4153,4178,4167,4167,4139,4160,4146,-18,-32,66,410.48 ,618
20140213,4160,4146,4178,4178,4162,4168,4171,22,25,44,275.33 ,620
20140214,4168,4171,4162,4274,4162,4270,4225,99,54,110,697.21 ,634
20140217,4270,4225,4395,4478,4297,4478,4391,253,166,182,1198.98 ,664
20140218,4478,4391,4456,4505,4415,4440,4443,49,52,250,1666.30 ,724
20140219,4440,4443,4421,4491,4421,4455,4458,12,15,354,2367.49 ,752
20140220,4455,4458,4478,4488,4402,4430,4446,-28,-12,186,1240.69 ,728
20140221,4430,4446,4406,4453,4397,4418,4431,-28,-15,70,465.30 ,726
20140224,4418,4431,4444,4444,4389,4420,4409,-11,-22,90,595.29 ,736
20140225,4420,4409,4484,4491,4439,4453,4458,44,49,370,2474.61 ,748
20140226,4453,4458,4444,4500,4423,4488,4457,30,-1,184,1230.28 ,688
20140227,4488,4457,4412,4415,4298,4322,4364,-135,-93,126,824.82 ,682
20140228,4322,4364,4324,4351,4301,4322,4327,-42,-37,70,454.36 ,674
20140303,4322,4327,4346,4390,4325,4381,4360,54,33,102,667.08 ,678
20140304,4381,4360,4388,4388,4333,4338,4361,-22,1,116,758.87 ,662
20140305,4338,4361,4308,4341,4308,4323,4318,-38,-43,236,1528.88 ,698
20140306,4323,4318,4313,4334,4310,4317,4321,-1,3,80,518.63 ,686
20140307,4317,4321,4277,4375,4277,4368,4343,47,22,98,638.43 ,680
20140310,4368,4343,4358,4362,4181,4209,4251,-134,-92,458,2920.60 ,708
20140311,4209,4251,4216,4263,4213,4242,4236,-9,-15,218,1385.27 ,718
20140312,4242,4236,4242,4304,4201,4274,4263,38,27,266,1701.17 ,742
20140313,4274,4263,4291,4356,4246,4310,4305,47,42,316,2040.92 ,722
20140314,4310,4305,4273,4316,4273,4300,4297,-5,-8,102,657.57 ,724
20140317,4300,4297,4412,4420,4308,4344,4361,47,64,226,1478.41 ,728
20140318,4344,4361,4328,4333,4263,4281,4295,-80,-66,212,1365.85 ,756
20140319,4281,4295,4190,4264,4190,4244,4238,-51,-57,188,1195.20 ,760
20140320,4244,4238,4235,4275,4207,4232,4228,-6,-10,302,1915.61 ,794
20140321,4232,4228,4121,4223,4121,4197,4203,-31,-25,624,3934.52 ,1154
20140324,4197,4203,4215,4230,4175,4184,4193,-19,-10,160,1006.44 ,1140
20140325,4184,4193,4173,4184,4148,4178,4169,-15,-24,454,2839.27 ,1168
20140326,4178,4169,4165,4191,4159,4190,4178,21,9,250,1566.95 ,1162
20140327,4190,4178,4178,4185,4140,4149,4158,-29,-20,1098,6848.54 ,1226
20140328,4149,4158,4118,4169,4118,4160,4153,2,-5,482,3003.03 ,1262
20140331,4160,4153,4162,4184,4151,4151,4162,-2,9,226,1411.09 ,1252
20140401,4151,4162,4161,4169,4112,4144,4134,-18,-28,684,4242.37 ,1310
20140402,4144,4134,4144,4158,4144,4150,4152,16,18,226,1407.74 ,1246
20140403,4150,4152,4181,4181,4147,4164,4159,12,7,294,1834.43 ,1244
20140404,4164,4159,4146,4156,4145,4147,4149,-12,-10,178,1107.80 ,1296
20140408,4147,4149,4162,4196,4158,4196,4179,47,30,180,1128.39 ,1308
20140409,4196,4179,4230,4230,4157,4182,4186,3,7,292,1833.80 ,1398
20140410,4182,4186,4136,4199,4136,4182,4166,-4,-20,202,1262.45 ,1358
20140411,4182,4166,4199,4199,4177,4177,4189,11,23,58,364.53 ,1360
20140414,4177,4189,4177,4194,4177,4194,4183,5,-6,34,213.37 ,1368
20140415,4194,4183,4184,4192,4140,4141,4160,-42,-23,494,3082.99 ,1600
20140416,4141,4160,4050,4100,4045,4070,4074,-90,-86,1220,7456.45 ,2062
20140417,4070,4074,4100,4104,4072,4078,4087,4,13,568,3482.13 ,1904
20140418,4078,4087,4078,4087,4064,4066,4075,-21,-12,228,1393.77 ,1874
20140421,4066,4075,4066,4078,3998,4000,4017,-75,-58,940,5665.12 ,2070
20140422,4000,4017,4036,4036,4003,4030,4013,13,-4,740,4455.23 ,2352
20140423,4030,4013,4026,4039,4022,4033,4030,20,17,246,1487.31 ,2424
20140424,4033,4030,4057,4057,4029,4046,4036,16,6,208,1259.51 ,2430
20140425,4046,4036,4025,4158,4009,4078,4098,42,62,1116,6860.23 ,2458
20140428,4078,4098,4101,4126,4089,4108,4110,10,12,672,4143.01 ,2366
20140429,4108,4110,4119,4122,4081,4082,4097,-28,-13,562,3454.26 ,2446
20140430,4082,4097,4078,4090,4060,4063,4078,-34,-19,1158,7084.21 ,2314
20140505,4063,4078,4100,4102,4079,4097,4090,19,12,512,3141.56 ,2306
20140506,4097,4090,4101,4117,4085,4103,4099,13,9,626,3849.83 ,2456
20140507,4103,4099,4098,4112,4097,4103,4103,4,4,500,3077.70 ,2436
20140508,4103,4103,4090,4096,4044,4057,4062,-46,-41,684,4168.23 ,2554
20140509,4057,4062,4059,4059,4030,4050,4043,-12,-19,1210,7338.46 ,2984
20140512,4050,4043,4050,4079,4037,4077,4054,34,11,750,4561.70 ,3002
20140513,4077,4054,4101,4124,4078,4085,4102,31,48,1040,6399.75 ,3124
20140514,4085,4102,4101,4105,4085,4105,4096,3,-6,506,3109.19 ,3138
20140515,4105,4096,4144,4156,3850,4122,4129,26,33,1370,8486.21 ,3222
20140516,4122,4129,4105,4114,4076,4076,4100,-53,-29,808,4969.68 ,3254
20140519,4076,4100,4075,4114,4066,4113,4083,13,-17,744,4557.21 ,3320
20140520,4113,4083,4130,4130,4080,4090,4092,7,9,518,3179.75 ,3424
20140521,4090,4092,4084,4117,4076,4108,4105,16,13,976,6010.86 ,3348
20140522,4108,4105,4098,4128,4094,4123,4111,18,6,532,3280.78 ,3352
20140523,4123,4111,4132,4135,4102,4122,4117,11,6,830,5126.33 ,3330
20140526,4122,4117,4100,4125,4100,4122,4116,5,-1,538,3322.07 ,3306
20140527,4122,4116,4120,4123,4086,4094,4105,-22,-11,790,4864.55 ,3346
20140528,4094,4105,4066,4081,4057,4072,4069,-33,-36,1408,8594.06 ,3320
20140529,4072,4069,4077,4080,4040,4046,4067,-23,-2,1020,6223.40 ,3450
20140530,4046,4067,4046,4073,4046,4072,4061,5,-6,678,4130.51 ,3452
20140603,4072,4061,4051,4062,4013,4062,4033,1,-28,462,2795.48 ,3462
20140604,4062,4033,4062,4062,4036,4049,4042,16,9,502,3044.30 ,3496
20140605,4049,4042,4046,4063,4039,4046,4047,4,5,668,4055.10 ,3528
20140606,4046,4047,4088,4088,4058,4069,4066,22,19,626,3818.78 ,3528
20140609,4069,4066,4061,4065,4032,4057,4046,-9,-20,490,2974.33 ,3580
20140610,4057,4046,4057,4057,4043,4053,4048,7,2,310,1882.50 ,3594
20140611,4053,4048,4057,4069,4054,4068,4062,20,14,210,1279.67 ,3590
20140612,4068,4062,4069,4069,4045,4051,4051,-11,-11,466,2831.88 ,3716
20140613,4051,4051,4056,4115,4056,4108,4087,57,36,802,4917.35 ,3896
20140616,4108,4087,4092,4166,4087,4144,4133,57,46,1252,7762.69 ,3822
20140617,4144,4133,4144,4144,4091,4100,4111,-33,-22,1168,7203.80 ,3792
20140618,4100,4111,4109,4127,4094,4113,4116,2,5,494,3050.28 ,3814
20140619,4113,4116,4114,4156,4114,4146,4140,30,24,922,5725.75 ,3916
20140620,4146,4140,4160,4337,4160,4315,4280,175,140,3114,19994.11 ,4124
20140623,4315,4280,4313,4363,4304,4325,4328,45,48,2656,17246.50 ,4424
20140624,4325,4328,4345,4345,4307,4335,4321,7,-7,1068,6923.24 ,4418
20140625,4335,4321,4344,4360,4280,4313,4309,-8,-12,2258,14594.97 ,3876
20140626,4313,4309,4321,4345,4304,4306,4316,-3,7,1212,7847.35 ,3706
20140627,4306,4316,4324,4363,4312,4334,4340,18,24,1022,6653.94 ,3606
20140630,4334,4340,4334,4349,4291,4302,4309,-38,-31,1746,11286.17 ,3492
20140701,4302,4309,4306,4349,4297,4314,4327,5,18,1662,10789.68 ,3006
20140702,4314,4327,4323,4341,4307,4325,4318,-2,-9,1206,7812.90 ,2638
20140703,4325,4318,4328,4349,4302,4309,4324,-9,6,748,4851.69 ,2596
20140704,4309,4324,4324,4338,4312,4334,4323,10,-1,552,3580.23 ,2546
20140707,4334,4323,4334,4338,4265,4279,4292,-44,-31,638,4107.94 ,2518
20140708,4279,4292,4295,4300,4264,4292,4283,0,-9,386,2480.27 ,2498
20140709,4292,4283,4303,4316,4282,4304,4303,21,20,270,1742.73 ,2470
20140710,4304,4303,4314,4345,4296,4316,4319,13,16,384,2487.96 ,2402
20140711,4316,4319,4347,4407,4347,4403,4392,84,73,630,4150.95 ,2366
20140714,4403,4392,4404,4407,4344,4349,4383,-43,-9,558,3668.79 ,2320
20140715,4349,4383,4329,4329,4301,4319,4312,-64,-71,474,3066.24 ,2336
20140716,4319,4312,4315,4334,4278,4296,4297,-16,-15,340,2191.79 ,2378
20140717,4296,4297,4297,4316,4289,4312,4306,15,9,448,2893.98 ,2222
20140718,4312,4306,4118,4364,4116,4336,4336,30,30,324,2107.35 ,2218
20140721,4336,4336,4310,4322,4299,4321,4309,-15,-27,186,1202.25 ,2116
20140722,4321,4309,4329,4335,4310,4327,4323,18,14,370,2399.74 ,2256
20140723,4327,4323,4338,4356,4327,4338,4335,15,12,526,3420.41 ,1984
20140724,4338,4335,4338,4339,4299,4304,4315,-31,-20,212,1372.27 ,1918
20140725,4304,4315,4315,4315,4251,4277,4270,-38,-45,1086,6955.88 ,2036
20140728,4277,4270,4277,4319,4260,4304,4291,34,21,466,2999.62 ,1920
20140729,4304,4291,4298,4306,4288,4297,4298,6,7,246,1586.15 ,1920
20140730,4297,4298,4319,4319,4289,4289,4299,-9,1,236,1522.09 ,1946
20140731,4289,4299,4290,4309,4290,4309,4302,10,3,82,529.16 ,1968
20140801,4309,4302,4300,4300,4283,4284,4287,-18,-15,78,501.65 ,1974
20140804,4284,4287,4288,4320,4288,4302,4304,15,17,190,1226.86 ,1970
20140805,4302,4304,4304,4310,4268,4296,4293,-8,-11,252,1622.92 ,1974
20140806,4296,4293,4269,4269,4236,4250,4251,-43,-42,784,4999.34 ,1988
20140807,4250,4251,4261,4280,4261,4261,4265,10,14,444,2840.88 ,1954
20140808,4261,4265,4247,4287,4246,4283,4261,18,-4,310,1981.61 ,2032
20140811,4283,4261,4258,4267,4255,4263,4259,2,-2,66,421.65 ,2028
20140812,4263,4259,4268,4270,4262,4263,4266,4,7,72,460.75 ,2016
20140813,4263,4266,4273,4276,4254,4266,4266,0,0,166,1062.34 ,2000
20140814,4266,4266,4272,4272,4240,4250,4250,-16,-16,190,1211.27 ,1896
20140815,4250,4250,4249,4257,4244,4251,4249,1,-1,432,2753.51 ,1556
20140818,4251,4249,4209,4220,4165,4181,4189,-68,-60,342,2149.31 ,1600
20140819,4181,4189,4181,4197,4155,4184,4188,-5,-1,322,2023.26 ,1630
20140820,4184,4188,4174,4186,4148,4179,4165,-9,-23,300,1874.54 ,1638
20140821,4179,4165,4179,4195,4164,4168,4175,3,10,716,4484.95 ,1984
20140822,4168,4175,4192,4192,4174,4180,4179,5,4,1084,6795.96 ,2464
20140825,4180,4179,4171,4184,4136,4179,4173,0,-6,72,450.71 ,2452
20140826,4179,4173,4187,4203,4169,4203,4179,30,6,438,2746.23 ,2370
20140827,4203,4179,4205,4207,4185,4199,4195,20,16,496,3121.32 ,2754
20140828,4199,4195,4190,4241,4183,4224,4211,29,16,216,1364.54 ,2688
20140829,4224,4211,4222,4245,4209,4245,4221,34,10,146,924.49 ,2676
20140901,4245,4221,4218,4223,4199,4208,4209,-13,-12,48,303.07 ,2672
20140902,4208,4209,4213,4213,4186,4186,4203,-23,-6,16,100.88 ,2668
20140903,4186,4203,4176,4176,4166,4166,4169,-37,-34,64,400.31 ,2648
20140904,4166,4169,4181,4183,4178,4180,4181,11,12,104,652.28 ,2572
20140905,4180,4181,4193,4218,4175,4175,4185,-6,4,120,753.39 ,2464
20140909,4175,4185,4174,4174,4155,4163,4164,-22,-21,184,1149.43 ,2292
20140910,4163,4164,4166,4220,4166,4200,4193,36,29,196,1233.01 ,2220
20140911,4200,4193,4227,4227,4160,4165,4166,-28,-27,104,649.90 ,2164
20140912,4165,4166,4166,4166,4102,4110,4131,-56,-35,332,2057.59 ,2068
20140915,4110,4131,4120,4130,4120,4120,4126,-11,-5,36,222.84 ,2064
20140102,4135,4146,4152,4240,4152,4240,4195,94,49,36,226.58 ,272
20140103,4240,4195,4236,4236,4212,4216,4220,21,25,8,50.65 ,276
20140106,4216,4220,4271,4271,4227,4227,4249,7,29,4,25.49 ,276
20140107,4227,4249,4231,4231,4231,4231,4231,-18,-18,4,25.39 ,280
20140108,4231,4231,4165,4165,4115,4115,4134,-116,-97,34,210.88 ,262
20140109,4115,4134,4070,4099,4070,4070,4083,-64,-51,8,49.01 ,264
20140110,4070,4083,4074,4098,4060,4098,4083,15,0,14,85.74 ,258
20140113,4098,4083,4161,4224,4161,4190,4194,107,111,14,88.08 ,256
20140114,4190,4194,4189,4189,4189,4189,4189,-5,-5,2,12.57 ,254
20140115,4189,4189,4167,4167,4167,4167,4167,-22,-22,2,12.50 ,256
20140116,4167,4167,4158,4158,4158,4158,4158,-9,-9,2,12.47 ,258
20140117,4158,4158,4172,4176,4170,4173,4172,15,14,8,50.07 ,254
20140120,4173,4172,4204,4204,4204,4204,4204,32,32,2,12.61 ,256
20140121,4204,4204,4185,4185,4185,4185,4185,-19,-19,2,12.56 ,258
20140122,4185,4185,4132,4132,4120,4131,4126,-54,-59,34,210.44 ,262
20140123,4131,4126,4099,4105,4090,4105,4099,-21,-27,28,172.19 ,262
20140124,4105,4099,4162,4182,4148,4154,4157,55,58,76,473.94 ,260
20140127,4154,4157,4140,4144,4132,4132,4140,-25,-17,64,397.53 ,260
20140128,4132,4140,,,,4135,4135,-5,-5,0,0.00 ,260
20140129,4135,4135,4121,4132,4100,4100,4111,-35,-24,20,123.36 ,266
20140130,4100,4111,4084,4084,4084,4084,4084,-27,-27,2,12.25 ,264
20140207,4084,4084,,,,4119,4119,35,35,0,0.00 ,264
20140210,4119,4119,4141,4179,4141,4178,4157,59,38,18,112.24 ,268
20140211,4178,4157,4202,4202,4168,4168,4175,11,18,50,313.15 ,286
20140212,4168,4175,4160,4164,4160,4164,4162,-11,-13,4,24.97 ,282
20140213,4164,4162,4180,4180,4176,4176,4178,14,16,4,25.07 ,278
20140214,4176,4178,4173,4266,4173,4266,4226,88,48,16,101.44 ,272
20140217,4266,4226,4331,4479,4331,4460,4436,234,210,48,319.44 ,274
20140218,4460,4436,4505,4505,4422,4435,4476,-1,40,52,349.15 ,294
20140219,4435,4476,4447,4447,4447,4447,4447,-29,-29,4,26.68 ,294
20140220,4447,4447,4415,4430,4415,4430,4420,-17,-27,6,39.78 ,296
20140221,4430,4420,,,,4405,4405,-15,-15,0,0.00 ,296
20140224,4405,4405,4452,4457,4392,4441,4427,36,22,54,358.61 ,296
20140225,4441,4427,4420,4488,4420,4450,4464,23,37,28,187.52 ,288
20140226,4450,4464,4451,4506,4427,4506,4468,42,4,80,536.25 ,286
20140227,4506,4468,4421,4421,4310,4336,4375,-132,-93,82,538.16 ,300
20140228,4336,4375,4346,4375,4340,4340,4350,-35,-25,48,313.21 ,288
20140303,4340,4350,4371,4398,4371,4398,4387,48,37,12,78.97 ,280
20140304,4398,4387,4393,4394,4348,4348,4376,-39,-11,28,183.80 ,280
20140305,4348,4376,4335,4335,4313,4330,4326,-46,-50,12,77.88 ,280
20140306,4330,4326,,,,4326,4326,0,0,0,0.00 ,280
20140307,4326,4326,4370,4381,4369,4369,4373,43,47,6,39.36 ,280
20140310,4369,4373,4283,4283,4222,4222,4252,-151,-121,4,25.52 ,282
20140311,4222,4252,4243,4262,4214,4262,4229,10,-23,34,215.71 ,272
20140312,4262,4229,4318,4318,4227,4290,4283,61,54,58,372.62 ,276
20140313,4290,4283,4290,4351,4290,4351,4315,68,32,20,129.46 ,274
20140314,4351,4315,4322,4329,4309,4309,4317,-6,2,14,90.68 ,272
20140317,4309,4317,4417,4417,4314,4331,4361,14,44,88,575.72 ,284
20140318,4331,4361,4345,4345,4295,4295,4319,-66,-42,14,90.71 ,278
20140319,4295,4319,4237,4267,4237,4254,4250,-65,-69,64,408.09 ,274
20140320,4254,4250,4232,4274,4225,4240,4245,-10,-5,20,127.37 ,278
20140321,4240,4245,4217,4226,4208,4216,4217,-29,-28,24,151.82 ,272
20140324,4216,4217,4229,4229,4196,4196,4216,-21,-1,10,63.24 ,274
20140325,4196,4216,4196,4196,4175,4179,4180,-37,-36,44,275.93 ,276
20140326,4179,4180,,,,4189,4189,9,9,0,0.00 ,276
20140327,4189,4189,4171,4171,4171,4171,4171,-18,-18,2,12.51 ,276
20140328,4171,4171,4178,4178,4178,4178,4178,7,7,4,25.07 ,272
20140331,4178,4178,4180,4180,4171,4171,4174,-7,-4,22,137.74 ,280
20140401,4171,4174,4180,4184,4137,4154,4169,-20,-5,46,287.71 ,290
20140402,4154,4169,4164,4166,4158,4160,4162,-9,-7,20,124.87 ,292
20140403,4160,4162,4185,4189,4166,4174,4175,12,13,120,751.60 ,366
20140404,4174,4175,4129,4164,4129,4161,4158,-14,-17,20,124.75 ,366
20140408,4161,4158,4174,4198,4166,4198,4174,40,16,16,100.18 ,362
20140409,4198,4174,4219,4219,4196,4196,4215,22,41,12,75.87 ,370
20140410,4196,4215,4030,4198,4030,4190,4111,-25,-104,108,666.01 ,376
20140411,4190,4111,4190,4207,4173,4180,4191,69,80,104,653.83 ,394
20140414,4180,4191,4181,4204,4181,4191,4192,0,1,18,113.21 ,394
20140415,4191,4192,4169,4169,4165,4166,4166,-26,-26,8,50.00 ,392
20140416,4166,4166,4096,4104,4078,4104,4092,-62,-74,12,73.66 ,398
20140417,4104,4092,4109,4109,4081,4081,4082,-11,-10,128,783.79 ,508
20140418,4081,4082,4086,4086,4077,4077,4084,-5,2,36,220.54 ,498
20140421,4077,4084,4072,4080,4009,4009,4025,-75,-59,76,458.93 ,460
20140422,4009,4025,4008,4026,4008,4025,4014,0,-11,54,325.19 ,452
20140423,4025,4014,4029,4040,4029,4040,4037,26,23,8,48.45 ,446
20140424,4040,4037,4040,4058,4026,4050,4043,13,6,22,133.44 ,440
20140425,4050,4043,4033,4161,4033,4096,4093,53,50,54,331.60 ,470
20140428,4096,4093,4101,4125,4101,4110,4114,17,21,94,580.10 ,476
20140429,4110,4114,4110,4120,4085,4085,4099,-29,-15,44,270.53 ,488
20140430,4085,4099,4091,4091,4068,4068,4081,-31,-18,28,171.44 ,496
20140505,4068,4081,4090,4123,4089,4106,4110,25,29,122,752.24 ,518
20140506,4106,4110,4117,4127,4093,4121,4116,11,6,296,1827.73 ,498
20140507,4121,4116,4111,4120,4105,4117,4114,1,-2,20,123.44 ,490
20140508,4117,4114,4117,4117,4052,4052,4084,-62,-30,26,159.29 ,494
20140509,4052,4084,4047,4060,4027,4060,4045,-24,-39,60,364.14 ,510
20140512,4060,4045,4052,4075,4037,4075,4055,30,10,72,438.01 ,528
20140513,4075,4055,4110,4127,4084,4084,4114,29,59,62,382.64 ,526
20140514,4084,4114,4102,4103,4094,4103,4098,-11,-16,10,61.48 ,524
20140515,4103,4098,4152,4152,4120,4120,4132,22,34,52,322.33 ,544
20140516,4120,4132,4110,4115,4084,4084,4099,-48,-33,48,295.13 ,552
20140519,4084,4099,4080,4113,4075,4113,4093,14,-6,46,282.43 ,562
20140520,4113,4093,4097,4098,4080,4086,4088,-7,-5,42,257.57 ,588
20140521,4086,4088,4080,4119,4079,4107,4094,19,6,48,294.81 ,586
20140522,4107,4094,4126,4128,4096,4118,4110,24,16,68,419.29 ,570
20140523,4118,4110,4138,4138,4106,4120,4116,10,6,84,518.63 ,574
20140526,4120,4116,4123,4123,4113,4113,4118,-3,2,82,506.60 ,578
20140527,4113,4118,4118,4119,4109,4111,4114,-7,-4,12,74.06 ,584
20140528,4111,4114,4105,4105,4053,4074,4062,-40,-52,132,804.41 ,560
20140529,4074,4062,4056,4063,4028,4034,4039,-28,-23,44,266.61 ,554
20140530,4034,4039,4033,4056,4032,4056,4047,17,8,36,218.59 ,558
20140603,4056,4047,4001,4031,4000,4031,4008,-16,-39,124,745.57 ,562
20140604,4031,4008,4035,4035,4021,4030,4029,22,21,28,169.25 ,566
20140605,4030,4029,4045,4053,4030,4036,4045,7,16,62,376.22 ,552
20140606,4036,4045,4067,4069,4063,4063,4065,18,20,76,463.49 ,568
20140609,4063,4065,4070,4070,4045,4048,4051,-17,-14,40,243.06 ,574
20140610,4048,4051,4057,4064,4057,4057,4058,6,7,84,511.35 ,608
20140611,4057,4058,4064,4072,4064,4067,4067,9,9,68,414.90 ,586
20140612,4067,4067,4055,4067,4053,4057,4055,-10,-12,56,340.66 ,616
20140613,4057,4055,4069,4122,4069,4122,4104,67,49,144,886.66 ,686
20140616,4122,4104,4106,4167,4101,4152,4141,48,37,136,844.90 ,682
20140617,4152,4141,4134,4134,4110,4110,4115,-31,-26,66,407.39 ,664
20140618,4110,4115,4127,4134,4116,4116,4126,1,11,34,210.47 ,676
20140619,4116,4126,4127,4157,4126,4156,4147,30,21,52,323.50 ,706
20140620,4156,4147,4187,4345,4177,4316,4288,169,141,152,977.84 ,740
20140623,4316,4288,4331,4363,4325,4337,4339,49,51,420,2733.98 ,966
20140624,4337,4339,4340,4340,4313,4318,4320,-21,-19,298,1931.48 ,808
20140625,4318,4320,4338,4360,4282,4303,4304,-17,-16,362,2337.48 ,636
20140626,4303,4304,4328,4353,4314,4320,4330,16,26,50,324.78 ,626
20140627,4320,4330,4318,4375,4318,4341,4354,11,24,22,143.69 ,630
20140630,4341,4354,4344,4351,4300,4303,4309,-51,-45,144,930.78 ,612
20140701,4303,4309,4282,4352,4281,4317,4307,8,-2,110,710.82 ,624
20140702,4317,4307,4330,4344,4309,4331,4326,24,19,38,246.62 ,628
20140703,4331,4326,4341,4348,4306,4306,4326,-20,0,144,934.62 ,618
20140704,4306,4326,4326,4346,4315,4338,4335,12,9,154,1001.52 ,560
20140707,4338,4335,4339,4339,4272,4272,4312,-63,-23,194,1254.91 ,470
20140708,4272,4312,4288,4295,4288,4295,4294,-17,-18,22,141.71 ,472
20140709,4295,4294,4316,4318,4297,4297,4300,3,6,24,154.81 ,470
20140710,4297,4300,4303,4345,4291,4321,4310,21,10,32,206.91 ,462
20140711,4321,4310,4386,4413,4380,4407,4393,97,83,46,303.18 ,452
20140714,4407,4393,4400,4408,4348,4348,4380,-45,-13,48,315.39 ,430
20140715,4348,4380,4313,4322,4307,4318,4314,-62,-66,76,491.88 ,418
20140716,4318,4314,4328,4328,4281,4291,4289,-23,-25,112,720.68 ,418
20140717,4291,4289,4307,4307,4298,4305,4302,16,13,56,361.43 ,428
20140718,4305,4302,4340,4355,4340,4350,4348,48,46,20,130.46 ,428
20140721,4350,4348,4311,4331,4302,4328,4311,-20,-37,48,310.39 ,432
20140722,4328,4311,4320,4326,4311,4311,4321,0,10,42,272.28 ,410
20140723,4311,4321,4326,4326,4324,4324,4324,3,3,38,246.47 ,424
20140724,4324,4324,4333,4338,4300,4305,4329,-19,5,94,610.46 ,400
20140725,4305,4329,4298,4298,4254,4270,4269,-59,-60,80,512.37 ,418
20140728,4270,4269,4267,4297,4267,4288,4287,19,18,82,527.41 ,400
20140729,4288,4287,4287,4298,4286,4292,4288,5,1,56,360.21 ,392
20140730,4292,4288,4305,4305,4275,4280,4285,-8,-3,26,167.12 ,396
20140731,4280,4285,4284,4287,4270,4287,4281,2,-4,30,192.68 ,398
20140801,4287,4281,4285,4287,4273,4282,4276,1,-5,48,307.94 ,410
20140804,4282,4276,4289,4311,4267,4287,4296,11,20,84,541.34 ,398
20140805,4287,4296,4252,4252,4249,4249,4250,-47,-46,16,102.00 ,406
20140806,4249,4250,4243,4243,4206,4229,4219,-21,-31,104,658.19 ,420
20140807,4229,4219,4239,4255,4235,4248,4240,29,21,86,547.01 ,418
20140808,4248,4240,4240,4250,4203,4250,4229,10,-11,44,279.14 ,412
20140811,4250,4229,4200,4253,4200,4236,4228,7,-1,272,1725.30 ,432
20140812,4236,4228,4236,4251,4236,4251,4241,23,13,10,63.62 ,430
20140813,4251,4241,4255,4255,4220,4254,4238,13,-3,126,801.05 ,412
20140814,4254,4238,4249,4249,4212,4212,4222,-26,-16,44,278.72 ,408
20140815,4212,4222,4223,4233,4223,4225,4226,3,4,60,380.42 ,404
20140818,4225,4226,4182,4183,4139,4157,4160,-69,-66,56,349.45 ,434
20140819,4157,4160,4157,4169,4152,4153,4157,-7,-3,34,212.04 ,456
20140820,4153,4157,4104,4138,4104,4138,4128,-19,-29,50,309.61 ,468
20140821,4138,4128,4134,4151,4121,4121,4134,-7,6,80,496.19 ,458
20140822,4121,4134,4128,4150,4127,4150,4135,16,1,84,521.11 ,398
20140825,4150,4135,4091,4148,4091,4148,4128,13,-7,38,235.30 ,398
20140826,4148,4128,4139,4169,4139,4169,4149,41,21,22,136.94 ,402
20140827,4169,4149,,,,4150,4150,1,1,0,0.00 ,402
20140828,4150,4150,4175,4218,4142,4198,4193,48,43,162,1019.12 ,356
20140829,4198,4193,4199,4200,4185,4189,4193,-4,0,34,213.86 ,338
20140901,4189,4193,4190,4192,4179,4184,4188,-9,-5,36,226.19 ,318
20140902,4184,4188,4172,4173,4156,4156,4164,-32,-24,8,49.97 ,316
20140903,4156,4164,4134,4135,4134,4135,4134,-29,-30,14,86.82 ,314
20140904,4135,4134,4148,4151,4147,4151,4150,17,16,24,149.42 ,336
20140905,4151,4150,4151,4160,4150,4150,4152,0,2,8,49.83 ,330
20140909,4150,4152,,,,4152,4152,0,0,0,0.00 ,330
20140910,4152,4152,4152,4156,4103,4156,4125,4,-27,96,594.05 ,364
20140911,4156,4125,4128,4128,4122,4122,4122,-3,-3,22,136.04 ,360
20140912,4122,4122,4108,4108,4056,4056,4089,-66,-33,150,920.07 ,398
20140915,4056,4089,4061,4093,4061,4093,4075,4,-14,94,574.62 ,454
20140916,4093,4075,4089,4089,4089,4089,4089,14,14,2,12.27 ,452
20140917,4089,4089,4096,4109,4095,4106,4102,17,13,100,615.32 ,448
20140918,4106,4102,4102,4123,4065,4082,4087,-20,-15,146,895.19 ,482
20140919,4082,4087,4072,4119,4039,4098,4070,11,-17,548,3346.10 ,654
20140922,4098,4070,4070,4088,3855,3880,4000,-190,-70,456,2736.32 ,602
20140923,3880,4000,3879,3950,3840,3892,3877,-108,-123,212,1233.20 ,492
20140924,3892,3877,3890,3891,3852,3872,3869,-5,-8,82,475.91 ,446
20140925,3872,3869,3842,3874,3834,3840,3844,-29,-25,170,980.38 ,494
20140926,3840,3844,3838,4049,3838,3900,3897,56,53,462,2700.87 ,366
20140929,3900,3897,3895,3934,3864,3888,3892,-9,-5,84,490.43 ,326
20140930,3888,3892,3900,3910,3840,3845,3898,-47,6,138,806.91 ,352
20141008,3845,3898,3800,3989,3800,3855,3872,-43,-26,100,580.84 ,360
20141009,3855,3872,3830,3915,3830,3915,3853,43,-19,52,300.57 ,372
20141010,3915,3853,3851,3981,3851,3910,3909,57,56,156,914.79 ,408
20141013,3910,3909,3900,3900,3900,3900,3900,-9,-9,4,23.40 ,412
20141014,3900,3900,3865,4089,3851,3950,3956,50,56,132,783.31 ,388
20141015,3950,3956,,,,3956,3956,0,0,0,0.00 ,388
20140102,4138,4151,4178,4227,4178,4227,4210,76,59,8,50.53 ,306
20140103,4227,4210,4254,4254,4219,4219,4227,9,17,28,177.55 ,284
20140106,4219,4227,4280,4280,4230,4244,4254,17,27,24,153.15 ,278
20140107,4244,4254,4239,4240,4237,4237,4238,-17,-16,18,114.45 ,282
20140108,4237,4238,4160,4160,4114,4114,4134,-124,-104,60,372.07 ,278
20140109,4114,4134,4142,4142,4050,4086,4083,-48,-51,116,710.51 ,278
20140110,4086,4083,4109,4139,4071,4139,4111,56,28,64,394.70 ,292
20140113,4139,4111,4103,4225,4103,4181,4185,70,74,62,389.30 ,276
20140114,4181,4185,4149,4225,4144,4213,4174,28,-11,108,676.22 ,266
20140115,4213,4174,4202,4202,4182,4182,4188,8,14,10,62.82 ,266
20140116,4182,4188,4159,4183,4148,4183,4163,-5,-25,6,37.47 ,270
20140117,4183,4163,4183,4184,4183,4184,4183,21,20,4,25.10 ,270
20140120,4184,4183,4200,4208,4200,4208,4204,25,21,6,37.84 ,272
20140121,4208,4204,4191,4194,4191,4194,4191,-10,-13,8,50.30 ,266
20140122,4194,4191,4130,4140,4130,4131,4133,-60,-58,6,37.20 ,264
20140123,4131,4133,4131,4134,4102,4104,4112,-29,-21,34,209.74 ,266
20140124,4104,4112,4161,4174,4155,4163,4163,51,51,64,399.66 ,286
20140127,4163,4163,4196,4196,4137,4143,4152,-20,-11,34,211.79 ,282
20140128,4143,4152,4137,4137,4135,4135,4136,-17,-16,8,49.64 ,282
20140129,4135,4136,4121,4121,4114,4114,4117,-22,-19,4,24.71 ,282
20140130,4114,4117,4146,4147,4094,4095,4121,-22,4,16,98.90 ,274
20140207,4095,4121,,,,4121,4121,0,0,0,0.00 ,274
20140210,4121,4121,4158,4185,4154,4185,4160,64,39,24,149.78 ,284
20140211,4185,4160,4194,4201,4181,4181,4190,21,30,92,578.29 ,322
20140212,4181,4190,4162,4189,4162,4189,4170,-1,-20,8,50.04 ,322
20140213,4189,4170,4192,4200,4190,4190,4195,20,25,8,50.34 ,322
20140214,4190,4195,4225,4291,4225,4291,4272,96,77,16,102.53 ,320
20140217,4291,4272,4345,4500,4339,4500,4444,228,172,44,293.34 ,308
20140218,4500,4444,4495,4518,4476,4476,4494,32,50,18,121.36 ,306
20140219,4476,4494,4467,4496,4467,4490,4483,-4,-11,10,67.25 ,304
20140220,4490,4483,4483,4504,4420,4427,4461,-56,-22,20,133.84 ,304
20140221,4427,4461,4460,4465,4449,4449,4458,-12,-3,6,40.12 ,302
20140224,4449,4458,4461,4461,4400,4456,4429,-2,-29,18,119.60 ,298
20140225,4456,4429,4466,4466,4466,4466,4466,37,37,2,13.40 ,296
20140226,4466,4466,4452,4515,4452,4515,4483,49,17,88,591.81 ,338
20140227,4515,4483,4425,4428,4334,4350,4362,-133,-121,48,314.12 ,342
20140228,4350,4362,4354,4370,4353,4361,4362,-1,0,36,235.56 ,338
20140303,4361,4362,4368,4400,4356,4399,4371,37,9,26,170.48 ,334
20140304,4399,4371,4407,4425,4371,4371,4407,0,36,24,158.67 ,332
20140305,4371,4407,4355,4373,4332,4373,4352,-34,-55,20,130.58 ,328
20140306,4373,4352,4372,4372,4359,4368,4367,16,15,8,52.41 ,326
20140307,4368,4367,4399,4399,4399,4399,4399,32,32,2,13.20 ,328
20140310,4399,4399,4344,4344,4219,4219,4263,-180,-136,60,383.70 ,320
20140311,4219,4263,4250,4286,4236,4267,4249,4,-14,40,254.99 ,300
20140312,4267,4249,4299,4302,4269,4296,4291,47,42,18,115.88 ,292
20140313,4296,4291,4332,4383,4321,4362,4348,71,57,12,78.28 ,292
20140314,4362,4348,4332,4344,4320,4327,4334,-21,-14,26,169.04 ,304
20140317,4327,4334,4434,4434,4364,4364,4403,30,69,22,145.32 ,296
20140318,4364,4403,4347,4374,4289,4304,4326,-99,-77,38,246.62 ,298
20140319,4304,4326,4238,4282,4238,4259,4260,-67,-66,16,102.25 ,296
20140320,4259,4260,4225,4257,4222,4257,4239,-3,-21,70,445.16 ,292
20140321,4257,4239,4214,4236,4214,4236,4218,-3,-21,28,177.17 ,282
20140324,4236,4218,4205,4205,4196,4203,4201,-15,-17,6,37.81 ,284
20140325,4203,4201,4202,4202,4174,4174,4192,-27,-9,6,37.73 ,282
20140326,4174,4192,4193,4193,4190,4190,4191,-2,-1,4,25.15 ,278
20140327,4190,4191,4180,4180,4180,4180,4180,-11,-11,4,25.08 ,276
20140328,4180,4180,,,,4187,4187,7,7,0,0.00 ,276
20140331,4187,4187,,,,4182,4182,-5,-5,0,0.00 ,276
20140401,4182,4182,4193,4193,4178,4178,4185,-4,3,4,25.11 ,274
20140402,4178,4185,4170,4170,4170,4170,4170,-15,-15,2,12.51 ,274
20140403,4170,4170,,,,4186,4186,16,16,0,0.00 ,274
20140404,4186,4186,,,,4186,4186,0,0,0,0.00 ,274
20140408,4186,4186,4207,4229,4207,4229,4218,43,32,4,25.31 ,276
20140409,4229,4218,4204,4217,4204,4217,4208,-1,-10,20,126.26 ,278
20140410,4217,4208,4165,4206,4165,4199,4194,-9,-14,8,50.33 ,276
20140411,4199,4194,4213,4213,4206,4206,4210,12,16,6,37.90 ,276
20140414,4206,4210,4193,4206,4191,4206,4197,-4,-13,128,805.97 ,272
20140415,4206,4197,4180,4180,4169,4170,4175,-27,-22,18,112.73 ,276
20140416,4170,4175,4105,4108,4088,4105,4101,-70,-74,22,135.35 ,274
20140417,4105,4101,4110,4110,4100,4100,4102,-1,1,8,49.23 ,272
20140418,4100,4102,4102,4102,4088,4088,4093,-14,-9,40,245.63 ,308
20140421,4088,4093,4087,4088,4018,4023,4036,-70,-57,52,314.86 ,296
20140422,4023,4036,4052,4052,4050,4050,4051,14,15,8,48.61 ,294
20140423,4050,4051,,,,4051,4051,0,0,0,0.00 ,294
20140424,4051,4051,4055,4060,4055,4060,4058,9,7,10,60.88 ,290
20140425,4060,4058,4143,4143,4115,4116,4122,58,64,14,86.56 ,300
20140428,4116,4122,,,,4143,4143,21,21,0,0.00 ,300
20140429,4143,4143,4125,4125,4092,4093,4105,-50,-38,32,197.07 ,322
20140430,4093,4105,4097,4097,4083,4083,4088,-22,-17,6,36.80 ,324
20140505,4083,4088,4118,4118,4097,4113,4111,25,23,20,123.35 ,322
20140506,4113,4111,4127,4130,4113,4115,4122,4,11,14,86.57 ,320
20140507,4115,4122,4127,4127,4127,4127,4127,5,5,4,24.76 ,316
20140508,4127,4127,4060,4062,4060,4062,4061,-65,-66,10,60.92 ,326
20140509,4062,4061,4048,4060,4045,4060,4051,-1,-10,6,36.46 ,330
20140512,4060,4051,4042,4075,4042,4075,4058,24,7,16,97.40 ,330
20140513,4075,4058,4114,4125,4080,4080,4104,22,46,18,110.83 ,334
20140514,4080,4104,4093,4107,4093,4107,4100,3,-4,8,49.20 ,334
20140515,4107,4100,4153,4153,4131,4131,4142,31,42,32,198.85 ,324
20140516,4131,4142,4108,4108,4086,4086,4100,-56,-42,18,110.71 ,326
20140519,4086,4100,4087,4109,4087,4109,4101,9,1,6,36.92 ,330
20140520,4109,4101,4116,4116,4085,4085,4100,-16,-1,24,147.63 ,326
20140521,4085,4100,4110,4110,4107,4107,4108,7,8,12,73.95 ,330
20140522,4107,4108,4116,4116,4116,4116,4116,8,8,2,12.35 ,330
20140523,4116,4116,4132,4132,4120,4120,4125,4,9,12,74.26 ,336
20140526,4120,4125,4117,4122,4116,4117,4118,-8,-7,14,86.50 ,332
20140527,4117,4118,4115,4115,4082,4089,4102,-29,-16,16,98.46 ,326
20140528,4089,4102,4068,4074,4058,4059,4066,-43,-36,54,329.38 ,346
20140529,4059,4066,4063,4063,4030,4031,4053,-35,-13,42,255.39 ,334
20140530,4031,4053,4031,4049,4031,4049,4042,-4,-11,28,169.79 ,348
20140603,4049,4042,3999,4027,3996,4027,4001,-15,-41,30,180.05 ,348
20140604,4027,4001,4040,4040,4036,4036,4038,35,37,4,24.23 ,348
20140605,4036,4038,4043,4051,4032,4036,4038,-2,0,78,472.52 ,348
20140606,4036,4038,4059,4071,4059,4067,4065,29,27,18,109.78 ,350
20140609,4067,4065,4044,4049,4044,4049,4045,-16,-20,6,36.41 ,350
20140610,4049,4045,,,,4051,4051,6,6,0,0.00 ,350
20140611,4051,4051,4067,4069,4060,4061,4062,10,11,126,767.76 ,376
20140612,4061,4062,4053,4056,4053,4055,4054,-7,-8,26,158.12 ,398
20140613,4055,4054,4084,4117,4083,4117,4101,63,47,32,196.87 ,394
20140616,4117,4101,4102,4176,4102,4165,4143,64,42,80,497.20 ,384
20140617,4165,4143,4135,4135,4107,4112,4122,-31,-21,30,185.53 ,372
20140618,4112,4122,4129,4139,4118,4118,4128,-4,6,12,74.31 ,374
20140619,4118,4128,4132,4167,4128,4141,4148,13,20,90,560.04 ,368
20140620,4141,4148,4210,4353,4210,4333,4318,185,170,178,1153.06 ,388
20140623,4333,4318,4331,4369,4331,4346,4350,28,32,98,639.45 ,396
20140624,4346,4350,4348,4350,4330,4336,4337,-14,-13,34,221.19 ,388
20140625,4336,4337,4376,4377,4300,4300,4338,-37,1,38,247.29 ,398
20140626,4300,4338,4343,4347,4325,4326,4337,-12,-1,32,208.20 ,396
20140627,4326,4337,4335,4348,4329,4348,4337,11,0,6,39.04 ,396
20140630,4348,4337,4343,4565,4106,4314,4358,-23,21,280,1830.48 ,404
20140701,4314,4358,4314,4329,4305,4328,4318,-30,-40,18,116.59 ,396
20140702,4328,4318,4343,4343,4323,4325,4334,7,16,18,117.04 ,394
20140703,4325,4334,4341,4353,4317,4317,4337,-17,3,64,416.35 ,374
20140704,4317,4337,4329,4348,4321,4347,4329,10,-8,140,909.21 ,362
20140707,4347,4329,4340,4340,4276,4280,4289,-49,-40,64,411.80 ,342
20140708,4280,4289,4280,4294,4280,4294,4287,5,-2,4,25.72 ,342
20140709,4294,4287,4306,4316,4292,4316,4306,29,19,52,335.94 ,352
20140710,4316,4306,4311,4349,4293,4349,4309,43,3,1016,6567.38 ,404
20140711,4349,4309,4388,4413,4050,4413,4400,104,91,392,2587.74 ,432
20140714,4413,4400,4402,4411,4350,4350,4401,-50,1,128,845.05 ,400
20140715,4350,4401,4317,4323,4313,4313,4320,-88,-81,42,272.16 ,396
20140716,4313,4320,4326,4338,4289,4293,4326,-27,6,64,415.35 ,346
20140717,4293,4326,4306,4309,4301,4301,4305,-25,-21,12,77.49 ,352
20140718,4301,4305,4304,4354,4304,4342,4343,37,38,48,312.73 ,348
20140721,4342,4343,4307,4331,4307,4329,4328,-14,-15,38,246.75 ,340
20140722,4329,4328,,,,4328,4328,0,0,0,0.00 ,340
20140723,4328,4328,4335,4349,4333,4336,4336,8,8,56,364.26 ,322
20140724,4336,4336,4335,4338,4321,4321,4328,-15,-8,28,181.79 ,322
20140725,4321,4328,4318,4318,4253,4266,4290,-62,-38,46,296.02 ,308
20140728,4266,4290,4268,4297,4268,4296,4292,6,2,44,283.29 ,308
20140729,4296,4292,4289,4293,4284,4292,4290,0,-2,24,154.46 ,292
20140730,4292,4290,4299,4299,4284,4284,4293,-6,3,76,489.45 ,292
20140731,4284,4293,4295,4295,4295,4295,4295,2,2,2,12.89 ,290
20140801,4295,4295,4288,4288,4262,4262,4276,-33,-19,6,38.49 ,292
20140804,4262,4276,4287,4299,4282,4290,4288,14,12,42,270.15 ,288
20140805,4290,4288,4264,4265,4264,4264,4264,-24,-24,6,38.38 ,284
20140806,4264,4264,4215,4229,4214,4218,4219,-46,-45,32,202.52 ,286
20140807,4218,4219,4235,4243,4234,4240,4238,21,19,8,50.86 ,282
20140808,4240,4238,4219,4237,4219,4237,4227,-1,-11,6,38.05 ,282
20140811,4237,4227,4232,4238,4226,4226,4234,-1,7,50,317.60 ,272
20140812,4226,4234,4235,4245,4235,4237,4241,3,7,18,114.51 ,272
20140813,4237,4241,4248,4249,4235,4235,4238,-6,-3,38,241.60 ,276
20140814,4235,4238,4239,4240,4209,4216,4230,-22,-8,74,469.59 ,288
20140815,4216,4230,4222,4222,4210,4210,4212,-20,-18,22,139.01 ,282
20140818,4210,4212,4164,4190,4137,4137,4170,-75,-42,388,2427.50 ,302
20140819,4137,4170,4132,4142,4129,4129,4135,-41,-35,18,111.65 ,298
20140820,4129,4135,4129,4129,4087,4104,4118,-31,-17,110,679.57 ,316
20140821,4104,4118,4115,4122,4114,4115,4115,-3,-3,72,444.50 ,362
20140822,4115,4115,4117,4133,4114,4133,4116,18,1,142,876.87 ,436
20140825,4133,4116,4120,4122,4120,4122,4121,6,5,4,24.73 ,434
20140826,4122,4121,4122,4122,4122,4122,4122,1,1,24,148.39 ,410
20140827,4122,4122,4142,4155,4128,4128,4142,6,20,24,149.14 ,408
20140828,4128,4142,4137,4146,4137,4146,4140,4,-2,14,86.96 ,406
20140829,4146,4140,4175,4175,4171,4172,4172,32,32,52,325.48 ,402
20140901,4172,4172,4172,4172,4154,4162,4161,-10,-11,18,112.37 ,400
20140902,4162,4161,4159,4165,4124,4139,4152,-22,-9,38,236.70 ,402
20140903,4139,4152,4119,4137,4114,4114,4122,-38,-30,80,494.69 ,408
20140904,4114,4122,4122,4126,4118,4126,4123,4,1,10,61.85 ,402
20140905,4126,4123,4148,4170,4113,4128,4132,5,9,132,818.28 ,404
20140909,4128,4132,4120,4120,4111,4111,4114,-21,-18,6,37.03 ,402
20140910,4111,4114,4119,4152,4119,4124,4127,10,13,12,74.29 ,400
20140911,4124,4127,4116,4127,4116,4127,4123,0,-4,6,37.11 ,400
20140912,4127,4123,4085,4107,4045,4045,4051,-78,-72,74,449.76 ,398
20140915,4045,4051,4045,4066,4045,4066,4055,15,4,4,24.33 ,396
20140916,4066,4055,4063,4104,4061,4092,4079,37,24,112,685.27 ,354
20140917,4092,4079,4083,4108,4080,4098,4091,19,12,88,540.08 ,350
20140918,4098,4091,4086,4113,4059,4067,4093,-24,2,64,392.96 ,360
20140919,4067,4093,4099,4099,4064,4076,4084,-17,-9,22,134.78 ,358
20140922,4076,4084,4068,4074,3838,3850,3865,-234,-219,262,1519.23 ,366
20140923,3850,3865,3831,3852,3806,3842,3836,-23,-29,70,402.87 ,360
20140924,3842,3836,3826,3850,3822,3850,3831,14,-5,26,149.43 ,346
20140925,3850,3831,3828,3831,3787,3788,3814,-43,-17,58,331.87 ,350
20140926,3788,3814,3788,3899,3769,3867,3854,53,40,300,1734.47 ,584
20140929,3867,3854,3849,3897,3837,3865,3866,11,12,100,580.04 ,564
20140930,3865,3866,3886,3928,3886,3906,3894,40,28,70,408.97 ,576
20141008,3906,3894,3875,3875,3841,3872,3869,-22,-25,26,150.92 ,576
20141009,3872,3869,3884,3940,3866,3930,3891,61,22,86,502.01 ,530
20141010,3930,3891,3955,3955,3899,3902,3927,11,36,104,612.68 ,446
20141013,3902,3927,3892,3958,3892,3936,3916,9,-11,42,246.76 ,422
20141014,3936,3916,3911,3931,3911,3931,3921,15,5,4,23.53 ,420
20141015,3931,3921,3904,3909,3880,3880,3893,-41,-28,26,151.85 ,420
20141016,3880,3893,3936,3936,3890,3915,3908,22,15,84,492.52 ,410
20141017,3915,3908,3868,3904,3850,3882,3879,-26,-29,38,221.14 ,412
20141020,3882,3879,3861,3870,3858,3870,3863,-9,-16,44,254.96 ,390
20141021,3870,3863,3865,3900,3865,3899,3873,36,10,16,92.97 ,390
20141022,3899,3873,3923,3926,3869,3914,3896,41,23,128,748.11 ,398
20141023,3914,3896,3883,3883,3835,3864,3857,-32,-39,98,567.11 ,396
20141024,3864,3857,3830,3882,3830,3834,3843,-23,-14,10,57.65 ,396
20141027,3834,3843,3847,3875,3824,3854,3851,11,8,40,231.09 ,368
20141028,3854,3851,3847,3856,3823,3823,3831,-28,-20,106,609.18 ,362
20141029,3823,3831,3818,3872,3818,3821,3825,-10,-6,480,2754.13 ,402
20141030,3821,3825,3820,3844,3728,3728,3824,-97,-1,56,321.26 ,380
20141031,3728,3824,3713,3850,3632,3850,3707,26,-117,34,189.06 ,376
20141103,3850,3707,3579,3579,3530,3530,3568,-177,-139,36,192.70 ,404
20141104,3530,3568,3502,3537,3433,3498,3501,-70,-67,48,252.10 ,380
20141105,3498,3501,3515,3515,3381,3418,3479,-83,-22,76,396.71 ,372
20141106,3418,3479,3330,3330,3323,3323,3326,-156,-153,20,99.80 ,356
20141107,3323,3326,3290,3318,3260,3318,3291,-8,-35,132,651.68 ,368
20141110,3318,3291,3232,3420,3232,3420,3386,129,95,296,1503.67 ,432
20141111,3420,3386,3444,3444,3381,3381,3412,-5,26,8,40.95 ,432
20141112,3381,3412,3411,3420,3406,3420,3418,8,6,116,594.80 ,376
20141113,3420,3418,3420,3420,3410,3410,3413,-8,-5,104,532.56 ,376
20141114,3410,3413,3325,3325,3320,3320,3324,-93,-89,64,319.17 ,316
20141117,3320,3324,3440,3440,3440,3440,3440,116,116,12,61.92 ,316
20140102,4142,4168,4150,4273,4150,4256,4233,88,65,1696,10769.75 ,5134
20140103,4256,4233,4227,4288,4221,4269,4258,36,25,2608,16658.12 ,4980
20140106,4269,4258,4275,4297,4237,4245,4253,-13,-5,3974,25353.75 ,5060
20140107,4245,4253,4231,4274,4226,4242,4253,-11,0,2076,13245.29 ,5180
20140108,4242,4253,4220,4238,4134,4139,4172,-114,-81,2762,17285.67 ,5332
20140109,4139,4172,4151,4169,4066,4102,4102,-70,-70,4368,26882.47 ,5222
20140110,4102,4102,4137,4167,4080,4136,4115,34,13,3906,24110.51 ,5122
20140113,4136,4115,4156,4251,4115,4198,4202,83,87,5460,34414.96 ,5516
20140114,4198,4202,4180,4254,4152,4227,4211,25,9,4612,29132.72 ,5978
20140115,4227,4211,4224,4262,4174,4186,4198,-25,-13,5640,35520.46 ,6418
20140116,4186,4198,4165,4210,4156,4198,4189,0,-9,3912,24582.61 ,6704
20140117,4198,4189,4171,4208,4171,4187,4193,-2,4,3254,20466.77 ,6858
20140120,4187,4193,4200,4236,4195,4229,4219,36,26,4492,28433.32 ,7346
20140121,4229,4219,4226,4238,4189,4197,4209,-22,-10,2892,18260.08 ,7340
20140122,4197,4209,4142,4164,4122,4140,4145,-69,-64,3166,19686.31 ,7590
20140123,4140,4145,4143,4153,4099,4117,4121,-28,-24,2646,16357.31 ,7722
20140124,4117,4121,4160,4205,4160,4174,4183,53,62,4202,26369.67 ,7208
20140127,4174,4183,4204,4214,4127,4152,4164,-31,-19,4048,25284.43 ,7298
20140128,4152,4164,4149,4158,4130,4150,4146,-14,-18,3518,21879.05 ,7840
20140129,4150,4146,4150,4150,4114,4130,4132,-16,-14,1696,10512.42 ,7780
20140130,4130,4132,4142,4162,4088,4108,4131,-24,-1,3520,21812.24 ,7358
20140207,4108,4131,4152,4188,4129,4142,4146,11,15,2342,14565.86 ,7358
20140210,4142,4146,4145,4206,4131,4203,4171,57,25,6120,38294.00 ,8324
20140211,4203,4171,4207,4227,4178,4188,4200,17,29,5122,32269.88 ,8944
20140212,4188,4200,4204,4225,4161,4192,4183,-8,-17,5508,34565.08 ,9666
20140213,4192,4183,4209,4211,4187,4194,4199,11,16,3186,20068.51 ,9904
20140214,4194,4199,4196,4309,4193,4308,4269,109,70,7638,48918.76 ,11204
20140217,4308,4269,4361,4525,4346,4519,4476,250,207,19752,132633.73 ,14566
20140218,4519,4476,4512,4544,4454,4476,4499,0,23,22166,149607.44 ,14950
20140219,4476,4499,4458,4532,4450,4496,4495,-3,-4,19752,133201.32 ,20346
20140220,4496,4495,4499,4521,4420,4453,4482,-42,-13,23112,155383.36 ,23524
20140221,4453,4482,4442,4484,4436,4458,4463,-24,-19,9144,61222.53 ,23686
20140224,4458,4463,4481,4492,4403,4475,4447,12,-16,15534,103641.48 ,23540
20140225,4475,4447,4510,4528,4475,4478,4500,31,53,15794,106621.54 ,23372
20140226,4478,4500,4469,4546,4456,4523,4499,23,-1,22864,154305.86 ,25288
20140227,4523,4499,4466,4467,4338,4370,4397,-129,-102,24566,162047.53 ,27010
20140228,4370,4397,4388,4410,4362,4371,4381,-26,-16,13726,90211.92 ,27308
20140303,4371,4381,4381,4438,4369,4426,4405,45,24,18298,120914.46 ,28046
20140304,4426,4405,4405,4448,4373,4378,4420,-27,15,13746,91155.22 ,28198
20140305,4378,4420,4355,4392,4350,4375,4370,-45,-50,11576,75896.34 ,28358
20140306,4375,4370,4375,4390,4357,4374,4376,4,6,11102,72885.72 ,28680
20140307,4374,4376,4370,4441,4365,4426,4406,50,30,11330,74892.51 ,28680
20140310,4426,4406,4371,4413,4224,4247,4294,-159,-112,28478,183453.75 ,28780
20140311,4247,4294,4274,4302,4247,4271,4271,-23,-23,20362,130477.04 ,32400
20140312,4271,4271,4307,4338,4228,4314,4294,43,23,25014,161119.52 ,33390
20140313,4314,4294,4324,4392,4301,4345,4348,51,54,23744,154875.33 ,35102
20140314,4345,4348,4322,4360,4310,4341,4338,-7,-10,16800,109333.86 ,35968
20140317,4341,4338,4436,4462,4351,4389,4407,51,69,22654,149763.77 ,36110
20140318,4389,4407,4382,4392,4297,4317,4334,-90,-73,22896,148870.16 ,38526
20140319,4317,4334,4247,4303,4230,4287,4275,-47,-59,20062,128655.05 ,40944
20140320,4287,4275,4257,4317,4238,4262,4268,-13,-7,28600,183113.89 ,42552
20140321,4262,4268,4202,4260,4202,4240,4239,-28,-29,18946,120495.74 ,43522
20140324,4240,4239,4250,4264,4205,4217,4230,-22,-9,17262,109535.84 ,44774
20140325,4217,4230,4191,4217,4175,4204,4197,-26,-33,18650,117417.64 ,45808
20140326,4204,4197,4209,4223,4187,4219,4206,22,9,13666,86228.20 ,46452
20140327,4219,4206,4206,4212,4162,4184,4188,-22,-18,19152,120321.89 ,48558
20140328,4184,4188,4180,4201,4168,4195,4188,7,0,14258,89571.14 ,49400
20140331,4195,4188,4188,4213,4185,4189,4197,1,9,17258,108657.35 ,50668
20140401,4189,4197,4198,4207,4157,4180,4181,-17,-16,20556,128933.36 ,53876
20140402,4180,4181,4187,4196,4177,4195,4188,14,7,13942,87584.22 ,54958
20140403,4195,4188,4212,4220,4189,4210,4204,22,16,18088,114083.25 ,54804
20140404,4210,4204,4193,4194,4140,4185,4185,-19,-19,13258,83242.66 ,57756
20140408,4185,4185,4188,4243,4188,4234,4216,49,31,21160,133835.78 ,57308
20140409,4234,4216,4234,4242,4215,4218,4230,2,14,20636,130936.58 ,59610
20140410,4218,4230,4170,4229,4161,4216,4200,-14,-30,26786,168769.11 ,61436
20140411,4216,4200,4231,4240,4202,4206,4222,6,22,22196,140594.44 ,63308
20140414,4206,4222,4205,4228,4204,4222,4218,0,-4,17242,109090.22 ,64302
20140415,4222,4218,4207,4223,4165,4165,4190,-53,-28,36348,228480.63 ,74184
20140416,4165,4190,4110,4132,4090,4113,4113,-77,-77,66494,410323.51 ,90224
20140417,4113,4113,4131,4137,4096,4099,4114,-14,1,51146,315681.56 ,100092
20140418,4099,4114,4106,4112,4083,4090,4099,-24,-15,43436,267084.29 ,104868
20140421,4090,4099,4092,4119,4014,4030,4049,-69,-50,67090,407486.48 ,113398
20140422,4030,4049,4034,4072,4023,4060,4044,11,-5,74704,453209.74 ,118368
20140423,4060,4044,4061,4080,4038,4061,4057,17,13,69762,424575.77 ,124140
20140424,4061,4057,4057,4073,4053,4068,4061,11,4,47608,290059.07 ,125378
20140425,4068,4061,4044,4225,4042,4103,4110,42,49,196486,1211525.09 ,131502
20140428,4103,4110,4118,4147,4109,4130,4130,20,20,125440,777220.79 ,139438
20140429,4130,4130,4140,4141,4085,4088,4105,-42,-25,104002,640403.39 ,157228
20140430,4088,4105,4090,4103,4072,4080,4085,-25,-20,111690,684544.67 ,183958
20140505,4080,4085,4110,4124,4105,4118,4112,33,27,80264,495145.80 ,191012
20140506,4118,4112,4136,4139,4106,4121,4122,9,10,124286,768605.81 ,198394
20140507,4121,4122,4124,4137,4120,4128,4126,6,4,99240,614315.23 ,207740
20140508,4128,4126,4115,4117,4056,4058,4078,-68,-48,223068,1364621.32 ,257174
20140509,4058,4078,4050,4062,4035,4058,4051,-20,-27,226508,1376460.02 ,292658
20140512,4058,4051,4056,4087,4038,4080,4061,29,10,389056,2370401.49 ,342292
20140513,4080,4061,4119,4135,4083,4094,4116,33,55,509068,3143180.69 ,367204
20140514,4094,4116,4109,4119,4094,4116,4107,0,-9,356140,2194277.22 ,374128
20140515,4116,4107,4165,4169,4128,4136,4140,29,33,655744,4073075.64 ,386500
20140516,4136,4140,4115,4123,4082,4086,4109,-54,-31,707062,4358477.96 ,393750
20140519,4086,4109,4080,4119,4072,4116,4094,7,-15,662404,4068006.91 ,413652
20140520,4116,4094,4126,4128,4081,4092,4103,-2,9,709702,4367888.57 ,420414
20140521,4092,4103,4082,4127,4077,4113,4107,10,4,911236,5614254.83 ,404148
20140522,4113,4107,4098,4133,4094,4131,4111,24,4,825028,5088385.92 ,414124
20140523,4131,4111,4144,4145,4105,4128,4125,17,14,772024,4777099.49 ,405660
20140526,4128,4125,4122,4129,4111,4121,4120,-4,-5,472584,2920826.95 ,401144
20140527,4121,4120,4123,4126,4085,4086,4107,-34,-13,463534,2855639.33 ,445944
20140528,4086,4107,4066,4076,4046,4066,4065,-41,-42,942616,5748664.19 ,451574
20140529,4066,4065,4071,4073,4016,4021,4051,-44,-14,898466,5459844.41 ,481452
20140530,4021,4051,4024,4057,4023,4055,4037,4,-14,837394,5071558.01 ,454228
20140603,4055,4037,4030,4040,3982,4038,4020,1,-17,312156,1882745.75 ,462664
20140604,4038,4020,4029,4044,4019,4036,4027,16,7,577894,3491424.09 ,470086
20140605,4036,4027,4039,4049,4029,4041,4040,14,13,537656,3258460.34 ,469398
20140606,4041,4040,4072,4083,4055,4070,4064,30,24,724202,4415798.01 ,453502
20140609,4070,4064,4066,4073,4031,4057,4049,-7,-15,723684,4395947.70 ,452176
20140610,4057,4049,4063,4064,4046,4053,4054,4,5,384502,2338463.50 ,438010
20140611,4053,4054,4058,4080,4056,4074,4067,20,13,459270,2802355.59 ,431786
20140612,4074,4067,4077,4077,4049,4058,4063,-9,-4,423912,2584017.81 ,423590
20140613,4058,4063,4062,4130,4058,4121,4090,58,27,1013246,6216929.22 ,428314
20140616,4121,4090,4114,4182,4104,4156,4138,66,48,929098,5768280.86 ,454052
20140617,4156,4138,4150,4151,4106,4118,4131,-20,-7,859212,5325354.66 ,425020
20140618,4118,4131,4114,4144,4110,4125,4129,-6,-2,701454,4344821.97 ,429202
20140619,4125,4129,4125,4175,4123,4164,4147,35,18,908184,5649827.37 ,452550
20140620,4164,4147,4192,4368,4188,4335,4280,188,133,3435902,22059163.97 ,550344
20140623,4335,4280,4338,4392,4328,4357,4362,77,82,2187908,14316696.23 ,559734
20140624,4357,4362,4373,4373,4335,4360,4352,-2,-10,1345170,8781991.40 ,565638
20140625,4360,4352,4379,4390,4306,4339,4357,-13,5,1907538,12468907.89 ,532808
20140626,4339,4357,4348,4378,4328,4335,4349,-22,-8,1363994,8899894.09 ,495556
20140627,4335,4349,4343,4384,4333,4346,4350,-3,1,1384210,9033041.87 ,509330
20140630,4346,4350,4350,4366,4302,4319,4340,-31,-10,1051206,6844550.53 ,482794
20140701,4319,4340,4315,4368,4307,4332,4334,-8,-6,1168864,7598986.36 ,462684
20140702,4332,4334,4338,4360,4321,4342,4342,8,8,1038612,6765406.94 ,452686
20140703,4342,4342,4342,4369,4315,4328,4347,-14,5,1266292,8257028.93 ,448024
20140704,4328,4347,4335,4358,4327,4353,4339,6,-8,1045254,6803337.57 ,471534
20140707,4353,4339,4347,4356,4260,4286,4313,-53,-26,860316,5566135.41 ,429458
20140708,4286,4313,4296,4315,4277,4310,4294,-3,-19,755290,4865784.72 ,421442
20140709,4310,4294,4318,4334,4292,4323,4313,29,19,1055534,6830321.00 ,426574
20140710,4323,4313,4331,4360,4298,4334,4327,21,14,1112624,7221543.33 ,447660
20140711,4334,4327,4374,4425,4370,4421,4404,94,77,1360226,8986646.53 ,492204
20140714,4421,4404,4413,4420,4347,4353,4391,-51,-13,965344,6358284.26 ,450420
20140715,4353,4391,4340,4340,4307,4327,4321,-64,-70,864812,5605792.64 ,424392
20140716,4327,4321,4327,4345,4282,4298,4309,-23,-12,1208670,7812586.85 ,438250
20140717,4298,4309,4305,4322,4291,4312,4306,3,-3,642114,4147912.23 ,436108
20140718,4312,4306,4311,4371,4303,4337,4339,31,33,1039886,6769411.34 ,408420
20140721,4337,4339,4315,4336,4293,4335,4315,-4,-24,761380,4928342.91 ,409916
20140722,4335,4315,4341,4342,4315,4328,4328,13,13,674040,4376557.36 ,424142
20140723,4328,4328,4338,4360,4323,4341,4338,13,10,837118,5447459.39 ,447776
20140724,4341,4338,4345,4350,4300,4321,4325,-17,-13,711982,4619320.58 ,453200
20140725,4321,4325,4325,4327,4251,4270,4277,-55,-48,1405948,9021186.63 ,471708
20140728,4270,4277,4277,4330,4258,4296,4285,19,8,905170,5819336.61 ,445724
20140729,4296,4285,4299,4301,4281,4292,4290,7,5,585510,3767861.86 ,452170
20140730,4292,4290,4311,4313,4270,4289,4288,-1,-2,736204,4736018.67 ,451678
20140731,4289,4288,4289,4309,4274,4307,4286,19,-2,649986,4179406.16 ,459330
20140801,4307,4286,4295,4296,4265,4275,4280,-11,-6,773312,4965315.52 ,448362
20140804,4275,4280,4290,4313,4276,4289,4294,9,14,745478,4801946.98 ,452688
20140805,4289,4294,4288,4295,4243,4274,4272,-20,-22,714512,4578810.08 ,487568
20140806,4274,4272,4258,4258,4205,4212,4222,-60,-50,1182886,7491751.79 ,528878
20140807,4212,4222,4230,4255,4227,4237,4240,15,18,781926,4973635.39 ,518338
20140808,4237,4240,4230,4261,4218,4253,4233,13,-7,793116,5036876.93 ,542052
20140811,4253,4233,4233,4243,4221,4229,4231,-4,-2,586666,3723566.33 ,525458
20140812,4229,4231,4240,4245,4231,4238,4236,7,5,412464,2621348.53 ,516208
20140813,4238,4236,4248,4250,4215,4237,4237,1,1,506238,3217838.89 ,517884
20140814,4237,4237,4238,4241,4194,4215,4216,-22,-21,685780,4337736.40 ,520478
20140815,4215,4216,4213,4227,4206,4216,4216,0,0,453006,2865287.87 ,520626
20140818,4216,4216,4154,4187,4113,4133,4154,-83,-62,1198662,7470648.39 ,456528
20140819,4133,4154,4139,4142,4122,4122,4133,-32,-21,373316,2314650.44 ,455378
20140820,4122,4133,4119,4120,4075,4108,4094,-25,-39,795890,4888420.51 ,443216
20140821,4108,4094,4108,4135,4084,4098,4114,4,20,758432,4680723.65 ,455874
20140822,4098,4114,4094,4134,4091,4122,4110,8,-4,508332,3134044.28 ,457348
20140825,4122,4110,4110,4129,4103,4114,4114,4,4,556536,3434682.89 ,467402
20140826,4114,4114,4114,4149,4102,4146,4122,32,8,474272,2932823.79 ,470556
20140827,4146,4122,4155,4158,4116,4132,4136,10,14,537758,3336496.26 ,469522
20140828,4132,4136,4135,4175,4111,4169,4140,33,4,666712,4140299.97 ,520354
20140829,4169,4140,4179,4179,4148,4162,4161,22,21,608892,3801184.79 ,515016
20140901,4162,4161,4159,4174,4140,4152,4158,-9,-3,446122,2782750.43 ,506372
20140902,4152,4158,4140,4155,4119,4123,4143,-35,-15,366706,2278924.05 ,504412
20140903,4123,4143,4102,4116,4094,4111,4105,-32,-38,602166,3708452.01 ,512322
20140904,4111,4105,4103,4119,4102,4108,4109,3,4,291490,1796784.49 ,518630
20140905,4108,4109,4111,4142,4089,4105,4115,-4,6,619874,3826998.15 ,513006
20140909,4105,4115,4100,4108,4082,4092,4095,-23,-20,189744,1165508.15 ,516016
20140910,4092,4095,4090,4124,4069,4114,4092,19,-3,621716,3816891.53 ,530836
20140911,4114,4092,4103,4115,4088,4098,4100,6,8,491756,3024875.15 ,530324
20140912,4098,4100,4078,4087,4018,4057,4056,-43,-44,1003966,6108780.73 ,574972
20140915,4057,4056,4046,4062,4025,4058,4041,2,-15,581616,3526191.72 ,557522
20140916,4058,4041,4051,4096,4044,4066,4063,25,22,550474,3355348.81 ,534146
20140917,4066,4063,4065,4089,4062,4081,4074,18,11,540762,3305004.89 ,528930
20140918,4081,4074,4075,4102,4039,4045,4063,-29,-11,514266,3134659.71 ,530176
20140919,4045,4063,4028,4088,4022,4053,4054,-10,-9,826186,5024190.92 ,529512
20140922,4053,4054,4057,4063,3810,3810,3929,-244,-125,2427488,14309388.92 ,657136
20140923,3810,3929,3817,3835,3762,3777,3794,-152,-135,1902036,10826020.83 ,636940
20140924,3777,3794,3799,3832,3782,3808,3802,14,8,957134,5459020.14 ,617838
20140925,3808,3802,3785,3807,3725,3751,3768,-51,-34,1781956,10072319.21 ,642024
20140926,3751,3768,3750,3856,3724,3822,3779,54,11,1582578,8972669.81 ,588982
20140929,3822,3779,3792,3847,3780,3816,3811,37,32,903886,5167755.36 ,550866
20140930,3816,3811,3820,3853,3814,3829,3831,18,20,537308,3087662.11 ,530598
20141008,3829,3831,3801,3828,3756,3799,3793,-32,-38,510916,2907311.88 ,517530
20141009,3799,3793,3803,3850,3780,3836,3806,43,13,1040930,5943435.97 ,547246
20141010,3836,3806,3832,3893,3813,3822,3841,16,35,1334068,7686852.11 ,585140
20141013,3822,3841,3827,3876,3805,3858,3836,17,-5,1121592,6454767.76 ,535076
20141014,3858,3836,3838,3860,3828,3845,3839,9,3,667994,3847512.10 ,535870
20141015,3845,3839,3852,3860,3793,3795,3828,-44,-11,947016,5437919.69 ,585078
20141016,3795,3828,3828,3888,3821,3832,3847,4,19,1609622,9289708.19 ,545682
20141017,3832,3847,3820,3842,3792,3824,3822,-23,-25,1147472,6579354.24 ,523572
20141020,3824,3822,3817,3834,3805,3832,3817,10,-5,794282,4548758.28 ,527100
20141021,3832,3817,3836,3847,3825,3840,3835,23,18,716048,4119400.92 ,519968
20141022,3840,3835,3860,3866,3832,3843,3852,8,17,760392,4394384.53 ,495230
20141023,3843,3852,3805,3818,3787,3799,3806,-53,-46,930950,5315496.15 ,532458
20141024,3799,3806,3801,3810,3783,3809,3793,3,-13,743580,4231306.82 ,530808
20141027,3809,3793,3807,3815,3786,3789,3800,-4,7,683730,3897413.43 ,529962
20141028,3789,3800,3793,3809,3776,3791,3789,-9,-11,686952,3905121.83 ,495880
20141029,3791,3789,3813,3822,3791,3807,3806,18,17,588402,3360067.06 ,483832
20141030,3807,3806,3791,3815,3708,3720,3773,-86,-33,1240642,7023254.98 ,521242
20141031,3720,3773,3670,3690,3584,3584,3641,-189,-132,2100408,11472155.62 ,502700
20141103,3584,3641,3510,3515,3433,3463,3483,-178,-158,1936994,10120671.46 ,420604
20141104,3463,3483,3480,3494,3449,3465,3472,-18,-11,887822,4624116.61 ,396322
20141105,3465,3472,3458,3470,3325,3335,3409,-137,-63,1229546,6287612.93 ,392638
20141106,3335,3409,3280,3329,3262,3288,3295,-121,-114,1615292,7985242.87 ,365622
20141107,3288,3295,3277,3306,3216,3291,3274,-4,-21,1447944,7112851.91 ,351690
20141110,3291,3274,3302,3419,3289,3377,3354,103,80,1681528,8461781.20 ,288298
20141111,3377,3354,3351,3387,3348,3366,3369,12,15,580444,2933692.13 ,273692
20141112,3366,3369,3370,3416,3365,3407,3395,38,26,356038,1813251.82 ,258138
20141113,3407,3395,3392,3410,3375,3394,3398,-1,3,273886,1396195.29 ,248954
20141114,3394,3398,3404,3423,3306,3329,3370,-69,-28,390174,1972559.13 ,231024
20141117,3329,3370,3328,3538,3313,3505,3440,135,70,637528,3289992.43 ,184920
20141118,3505,3440,3485,3508,3462,3489,3484,49,44,277460,1450212.91 ,163836
20141119,3489,3484,3498,3513,3476,3499,3496,15,12,154418,809779.60 ,160936
20141120,3499,3496,3497,3552,3423,3468,3476,-28,-20,297942,1553688.13 ,145854
20141121,3468,3476,3476,3496,3462,3493,3481,17,5,133650,697867.79 ,136578
20141124,3493,3481,3514,3566,3504,3526,3534,45,53,275550,1461037.43 ,122852
20141125,3526,3534,3520,3547,3515,3545,3531,11,-3,84584,448012.01 ,113058
20141126,3545,3531,3554,3562,3512,3530,3533,-1,2,119702,634441.00 ,88204
20141127,3530,3533,3530,3531,3452,3488,3494,-45,-39,112570,590123.65 ,64170
20141128,3488,3494,3485,3485,3429,3440,3449,-54,-45,65622,339510.38 ,47834
20141201,3440,3449,3443,3443,3276,3276,3353,-173,-96,15878,79867.39 ,46064
20141202,3276,3353,3306,3568,3306,3493,3454,140,101,49536,256707.26 ,28656
20141203,3493,3454,3454,3525,3442,3486,3493,32,39,16640,87203.12 ,21500
20141204,3486,3493,3490,3510,3472,3491,3492,-2,-1,15732,82412.57 ,15276
20141205,3491,3492,3485,3536,3475,3502,3495,10,3,9916,51991.79 ,14588
20141208,3502,3495,3517,3532,3460,3479,3484,-16,-11,6684,34937.81 ,11948
20141209,3479,3484,3472,3509,3466,3506,3485,22,1,2952,15432.49 ,10368
20141210,3506,3485,3548,3659,3548,3659,3622,174,137,5396,29324.44 ,8080
20141211,3659,3622,3894,3894,3592,3650,3674,28,52,1160,6394.36 ,7268
20141212,3650,3674,3680,3680,3630,3645,3655,-29,-19,460,2522.16 ,7080
20141215,3645,3655,3660,3660,3580,3602,3614,-53,-41,460,2494.15 ,6688
20140116,4198,4198,4174,4250,4156,4218,4199,20,1,230,1448.72 ,12
20140117,4218,4199,4193,4218,4191,4211,4199,12,0,36,226.77 ,14
20140120,4211,4199,4230,4230,4230,4230,4230,31,31,4,25.38 ,16
20140121,4230,4230,4168,4220,4168,4220,4194,-10,-36,4,25.16 ,16
20140122,4220,4194,4133,4164,4133,4164,4146,-30,-48,22,136.84 ,14
20140123,4164,4146,4164,4164,4120,4120,4142,-26,-4,4,24.85 ,16
20140124,4120,4142,4184,4235,4179,4179,4189,37,47,118,741.63 ,18
20140127,4179,4189,4202,4203,4190,4190,4198,1,9,6,37.79 ,18
20140128,4190,4198,4145,4164,4145,4164,4152,-34,-46,8,49.83 ,18
20140129,4164,4152,4142,4159,4142,4143,4149,-9,-3,10,62.25 ,20
20140130,4143,4149,4162,4162,4104,4111,4134,-38,-15,16,99.22 ,22
20140207,4111,4134,4155,4155,4155,4155,4155,21,21,2,12.47 ,22
20140210,4155,4155,4148,4200,4144,4200,4163,45,8,16,99.93 ,28
20140211,4200,4163,4226,4226,4183,4183,4198,20,35,22,138.55 ,34
20140212,4183,4198,4187,4193,4178,4192,4186,-6,-12,10,62.79 ,32
20140213,4192,4186,4201,4207,4200,4200,4204,14,18,14,88.30 ,26
20140214,4200,4204,4197,4300,4197,4300,4274,96,70,18,115.41 ,36
20140217,4300,4274,4354,4530,4354,4530,4476,256,202,38,255.15 ,46
20140218,4530,4476,4523,4525,4467,4467,4487,-9,11,26,174.99 ,52
20140219,4467,4487,4451,4534,4451,4503,4503,16,16,56,378.28 ,60
20140220,4503,4503,4513,4529,4444,4466,4483,-37,-20,62,416.98 ,78
20140221,4466,4483,4457,4488,4457,4464,4475,-19,-8,42,281.93 ,80
20140224,4464,4475,4481,4495,4444,4481,4466,6,-9,80,535.97 ,70
20140225,4481,4466,4537,4537,4494,4494,4512,28,46,64,433.20 ,84
20140226,4494,4512,4494,4550,4476,4538,4511,26,-1,72,487.19 ,114
20140227,4538,4511,4452,4480,4366,4374,4397,-137,-114,266,1754.77 ,122
20140228,4374,4397,4391,4411,4389,4389,4398,-8,1,18,118.77 ,122
20140303,4389,4398,4387,4444,4387,4444,4430,46,32,40,265.82 ,120
20140304,4444,4430,4446,4451,4412,4412,4438,-18,8,24,159.78 ,120
20140305,4412,4438,4381,4389,4379,4380,4383,-58,-55,42,276.14 ,128
20140306,4380,4383,4402,4402,4365,4365,4386,-18,3,16,105.29 ,128
20140307,4365,4386,4430,4437,4424,4424,4431,38,45,32,212.73 ,136
20140310,4424,4431,4403,4403,4250,4250,4288,-181,-143,66,424.51 ,144
20140311,4250,4288,4206,4310,4206,4280,4276,-8,-12,102,654.23 ,158
20140312,4280,4276,4331,4331,4258,4326,4293,50,17,40,257.61 ,160
20140313,4326,4293,4339,4400,4330,4400,4363,107,70,12,78.53 ,156
20140314,4400,4363,4350,4363,4350,4357,4358,-6,-5,8,52.30 ,156
20140317,4357,4358,4454,4460,4380,4406,4427,48,69,40,265.66 ,160
20140318,4406,4427,4352,4392,4330,4330,4346,-97,-81,66,430.29 ,166
20140319,4330,4346,4267,4306,4264,4297,4283,-49,-63,62,398.37 ,162
20140320,4297,4283,4280,4287,4251,4272,4271,-11,-12,40,256.28 ,176
20140321,4272,4271,4238,4258,4238,4257,4249,-14,-22,32,203.98 ,176
20140324,4257,4249,4263,4263,4224,4224,4238,-25,-11,60,381.49 ,176
20140325,4224,4238,4216,4216,4196,4208,4206,-30,-32,38,239.79 ,192
20140326,4208,4206,4207,4221,4207,4219,4217,13,11,70,442.79 ,192
20140327,4219,4217,4209,4218,4191,4197,4200,-20,-17,44,277.25 ,194
20140328,4197,4200,4187,4203,4187,4199,4194,-1,-6,38,239.11 ,196
20140331,4199,4194,4208,4213,4194,4194,4203,0,9,14,88.28 ,196
20140401,4194,4203,4206,4208,4181,4185,4200,-18,-3,60,378.05 ,198
20140402,4185,4200,4186,4204,4186,4202,4199,2,-1,50,314.98 ,202
20140403,4202,4199,4219,4223,4202,4213,4215,14,16,32,202.36 ,202
20140404,4213,4215,4200,4203,4194,4194,4199,-21,-16,10,62.99 ,206
20140408,4194,4199,4217,4239,4214,4239,4220,40,21,22,139.26 ,202
20140409,4239,4220,4251,4251,4227,4227,4241,7,21,10,63.62 ,204
20140410,4227,4241,4186,4230,4186,4222,4210,-19,-31,46,290.54 ,206
20140411,4222,4210,4237,4249,4217,4220,4232,10,22,72,457.12 ,210
20140414,4220,4232,4229,4230,4220,4230,4225,-2,-7,10,63.39 ,206
20140415,4230,4225,4226,4233,4187,4187,4203,-38,-22,130,819.70 ,236
20140416,4187,4203,4116,4145,4109,4123,4129,-80,-74,204,1263.54 ,318
20140417,4123,4129,4157,4157,4108,4109,4122,-20,-7,74,457.55 ,340
20140418,4109,4122,4114,4116,4091,4097,4104,-25,-18,90,554.08 ,378
20140421,4097,4104,4103,4106,4027,4033,4055,-71,-49,206,1253.07 ,430
20140422,4033,4055,4072,4074,4039,4071,4055,16,0,96,584.06 ,446
20140423,4071,4055,4068,4083,4063,4068,4073,13,18,22,134.41 ,446
20140424,4068,4073,4070,4070,4070,4070,4070,-3,-3,6,36.63 ,448
20140425,4070,4070,4073,4156,4073,4105,4126,35,56,130,804.71 ,442
20140428,4105,4126,4125,4147,4120,4129,4135,3,9,226,1401.95 ,438
20140429,4129,4135,4133,4133,4098,4099,4116,-36,-19,172,1062.17 ,492
20140430,4099,4116,4094,4108,4077,4083,4090,-33,-26,54,331.33 ,494
20140505,4083,4090,4100,4123,4100,4120,4118,30,28,42,259.44 ,470
20140506,4120,4118,4136,4139,4118,4118,4131,0,13,232,1437.69 ,466
20140507,4118,4131,4127,4136,4124,4128,4129,-3,-2,46,284.93 ,462
20140508,4128,4129,4100,4103,4063,4066,4076,-63,-53,92,562.59 ,454
20140509,4066,4076,4062,4062,4039,4056,4050,-20,-26,124,753.48 ,476
20140512,4056,4050,4058,4087,4040,4085,4060,35,10,176,1071.97 ,514
20140513,4085,4060,4140,4140,4090,4098,4113,38,53,1880,11601.19 ,848
20140514,4098,4113,4112,4123,4106,4123,4113,10,0,158,974.84 ,848
20140515,4123,4113,4187,4187,4137,4138,4148,25,35,156,970.77 ,782
20140516,4138,4148,4123,4126,4092,4092,4113,-56,-35,86,530.64 ,784
20140519,4092,4113,4095,4121,4080,4120,4097,7,-16,400,2458.51 ,788
20140520,4120,4097,4122,4122,4089,4099,4098,2,1,70,430.37 ,818
20140521,4099,4098,4119,4125,4114,4117,4120,19,22,32,197.80 ,822
20140522,4117,4120,4109,4135,4107,4135,4119,15,-1,64,395.46 ,816
20140523,4135,4119,4150,4150,4113,4128,4130,9,11,124,768.31 ,834
20140526,4128,4130,4129,4131,4118,4128,4124,-2,-6,54,334.08 ,830
20140527,4128,4124,4117,4124,4092,4097,4105,-27,-19,150,923.68 ,882
20140528,4097,4105,4081,4081,4051,4066,4064,-39,-41,434,2646.23 ,1100
20140529,4066,4064,4071,4071,4019,4024,4051,-40,-13,370,2248.83 ,1172
20140530,4024,4051,4030,4061,4026,4061,4043,10,-8,528,3202.29 ,1250
20140603,4061,4043,4051,4051,3994,4037,4022,-6,-21,274,1653.09 ,1256
20140604,4037,4022,4029,4037,4023,4035,4029,13,7,64,386.84 ,1242
20140605,4035,4029,4049,4051,4037,4041,4048,12,19,338,2052.41 ,1480
20140606,4041,4048,4063,4084,4063,4077,4073,29,25,168,1026.63 ,1466
20140609,4077,4073,4071,4071,4036,4058,4054,-15,-19,116,705.44 ,1462
20140610,4058,4054,4058,4066,4052,4062,4058,8,4,114,694.07 ,1456
20140611,4062,4058,4071,4079,4070,4075,4072,17,14,156,953.00 ,1418
20140612,4075,4072,4081,4081,4056,4061,4070,-11,-2,78,476.27 ,1404
20140613,4061,4070,4073,4131,4067,4130,4097,60,27,376,2310.79 ,1456
20140616,4130,4097,4096,4180,4096,4173,4161,76,64,374,2334.56 ,1450
20140617,4173,4161,4221,4221,4114,4120,4131,-41,-30,390,2417.14 ,1456
20140618,4120,4131,4121,4145,4121,4126,4132,-5,1,94,582.70 ,1444
20140619,4126,4132,4133,4174,4133,4166,4156,34,24,186,1159.76 ,1454
20140620,4166,4156,4199,4362,4193,4344,4307,188,151,1698,10971.15 ,1596
20140623,4344,4307,4339,4392,4335,4358,4364,51,57,1376,9008.98 ,1524
20140624,4358,4364,4382,4382,4342,4364,4353,0,-11,306,1998.03 ,1478
20140625,4364,4353,4373,4391,4314,4344,4360,-9,7,898,5873.09 ,1448
20140626,4344,4360,4350,4376,4334,4338,4350,-22,-10,290,1892.52 ,1438
20140627,4338,4350,4350,4385,4340,4357,4355,7,5,264,1724.75 ,1430
20140630,4357,4355,4350,4367,4306,4325,4334,-30,-21,312,2028.62 ,1436
20140701,4325,4334,4323,4370,4316,4337,4343,3,9,256,1667.93 ,1410
20140702,4337,4343,4341,4362,4329,4347,4343,4,0,186,1211.90 ,1426
20140703,4347,4343,4353,4370,4322,4330,4349,-13,6,144,939.59 ,1394
20140704,4330,4349,4340,4364,4334,4356,4348,7,-1,156,1017.64 ,1428
20140707,4356,4348,4356,4574,4282,4294,4320,-54,-28,610,3953.64 ,1582
20140708,4294,4320,4295,4322,4290,4320,4306,0,-14,304,1963.75 ,1578
20140709,4320,4306,4324,4340,4306,4330,4330,24,24,164,1065.24 ,1620
20140710,4330,4330,4330,4362,4312,4344,4343,14,13,250,1628.83 ,1636
20140711,4344,4343,4386,4429,4372,4427,4416,84,73,2142,14191.29 ,1774
20140714,4427,4416,4415,4426,4356,4365,4398,-51,-18,550,3629.09 ,1760
20140715,4365,4398,4333,4339,4319,4338,4328,-60,-70,212,1376.36 ,1758
20140716,4338,4328,4320,4352,4294,4308,4314,-20,-14,272,1760.29 ,1796
20140717,4308,4314,4307,4329,4301,4324,4315,10,1,386,2498.61 ,1768
20140718,4324,4315,4320,4412,4313,4344,4355,29,40,212,1385.12 ,1800
20140721,4344,4355,4321,4345,4309,4345,4326,-10,-29,182,1181.22 ,1772
20140722,4345,4326,4347,4347,4326,4335,4335,9,9,88,572.27 ,1780
20140723,4335,4335,4348,4364,4332,4350,4348,15,13,140,913.24 ,1790
20140724,4350,4348,4348,4356,4312,4333,4324,-15,-24,320,2075.96 ,1774
20140725,4333,4324,4335,4336,4265,4290,4289,-34,-35,904,5817.12 ,2090
20140728,4290,4289,4289,4328,4274,4313,4303,24,14,378,2439.92 ,2098
20140729,4313,4303,4298,4315,4297,4303,4307,0,4,432,2791.02 ,2276
20140730,4303,4307,4322,4322,4291,4307,4301,0,-6,420,2709.87 ,2238
20140731,4307,4301,4305,4318,4294,4318,4307,17,6,696,4497.00 ,2054
20140801,4318,4307,4305,4308,4280,4283,4291,-24,-16,928,5973.44 ,1816
20140804,4283,4291,4299,4324,4290,4304,4300,13,9,482,3109.44 ,1984
20140805,4304,4300,4303,4304,4257,4286,4277,-14,-23,364,2335.74 ,2020
20140806,4286,4277,4263,4263,4217,4217,4230,-60,-47,1374,8718.66 ,1520
20140807,4217,4230,4230,4252,4230,4240,4243,10,13,688,4379.45 ,1534
20140808,4240,4243,4232,4264,4225,4255,4243,12,0,448,2851.31 ,1504
20140811,4255,4243,4234,4251,4224,4230,4244,-13,1,4036,25698.64 ,2526
20140812,4230,4244,4244,4244,4233,4242,4236,-2,-8,196,1245.55 ,2524
20140813,4242,4236,4315,4315,4223,4237,4239,1,3,806,5125.01 ,2172
20140814,4237,4239,4240,4242,4199,4216,4218,-23,-21,626,3960.80 ,2072
20140815,4216,4218,4228,4228,4209,4219,4217,1,-1,322,2036.91 ,2032
20140818,4219,4217,4102,4185,4102,4136,4146,-81,-71,1076,6691.84 ,1972
20140819,4136,4146,4140,4144,4125,4125,4135,-21,-11,788,4887.90 ,1968
20140820,4125,4135,4111,4118,4082,4116,4098,-19,-37,990,6086.46 ,1946
20140821,4116,4098,4112,4136,4087,4095,4110,-3,12,1550,9557.54 ,2236
20140822,4095,4110,4090,4129,4090,4115,4111,5,1,1392,8583.90 ,2224
20140825,4115,4111,4105,4120,4098,4109,4109,-2,-2,642,3957.79 ,2122
20140826,4109,4109,4111,4140,4100,4137,4125,28,16,760,4702.84 ,2008
20140827,4137,4125,4142,4142,4114,4127,4125,2,0,500,3094.35 ,1980
20140828,4127,4125,4131,4160,4108,4148,4137,23,12,1400,8688.06 ,2376
20140829,4148,4137,4180,4180,4126,4133,4136,-4,-1,1000,6204.90 ,2680
20140901,4133,4136,4146,4146,4116,4120,4127,-16,-9,234,1448.91 ,2680
20140902,4120,4127,4119,4125,4095,4095,4110,-32,-17,264,1627.85 ,2680
20140903,4095,4110,4055,4087,4055,4078,4078,-32,-32,284,1737.46 ,2672
20140904,4078,4078,4079,4090,4076,4078,4083,0,5,138,845.27 ,2654
20140905,4078,4083,4082,4109,4062,4080,4082,-3,-1,294,1800.21 ,2662
20140909,4080,4082,4064,4077,4053,4066,4064,-16,-18,164,999.83 ,2652
20140910,4066,4064,4064,4092,4043,4086,4076,22,12,566,3460.62 ,2696
20140911,4086,4076,4051,4083,4051,4072,4072,-4,-4,258,1575.95 ,2690
20140912,4072,4072,4055,4057,3997,4028,4021,-44,-51,962,5802.80 ,2704
20140915,4028,4021,4013,4035,4000,4032,4018,11,-3,942,5678.63 ,2752
20140916,4032,4018,4022,4066,4015,4039,4043,21,25,378,2292.92 ,2686
20140917,4039,4043,4047,4056,4039,4054,4049,11,6,164,996.16 ,2714
20140918,4054,4049,4042,4070,4014,4020,4036,-29,-13,390,2361.48 ,2738
20140919,4020,4036,4000,4055,3998,4026,4026,-10,-10,376,2270.77 ,2692
20140922,4026,4026,4030,4039,3784,3791,3865,-235,-161,1872,10853.03 ,2762
20140923,3791,3865,3813,3813,3739,3763,3776,-102,-89,2444,13843.56 ,2510
20140924,3763,3776,3790,3808,3767,3786,3786,10,10,1606,9121.33 ,2410
20140925,3786,3786,3765,3780,3708,3726,3744,-60,-42,2298,12908.48 ,2440
20140926,3726,3744,3730,3836,3708,3807,3766,63,22,2204,12450.65 ,2482
20140929,3807,3766,3801,3825,3761,3790,3795,24,29,1246,7093.00 ,2554
20140930,3790,3795,3800,3823,3787,3791,3802,-4,7,702,4004.21 ,2592
20141008,3791,3802,3830,3830,3727,3770,3760,-32,-42,626,3531.45 ,2654
20141009,3770,3760,3790,3812,3752,3803,3783,43,23,1506,8546.55 ,2572
20141010,3803,3783,3704,3856,3704,3790,3808,7,25,2046,11689.16 ,2768
20141013,3790,3808,3796,3845,3781,3833,3819,25,11,1450,8307.32 ,2828
20141014,3833,3819,3819,3831,3805,3814,3816,-5,-3,1422,8141.62 ,2862
20141015,3814,3816,3818,3828,3770,3770,3792,-46,-24,956,5438.66 ,2958
20141016,3770,3792,3803,3859,3796,3802,3813,10,21,2678,15320.52 ,3016
20141017,3802,3813,3790,3811,3767,3798,3793,-15,-20,1832,10424.13 ,3170
20141020,3798,3793,3781,3803,3775,3798,3790,5,-3,948,5390.10 ,3190
20141021,3798,3790,3806,3815,3798,3803,3805,13,15,1398,7980.56 ,3202
20141022,3803,3805,3820,3833,3805,3819,3820,14,15,1452,8320.50 ,3308
20141023,3819,3820,3797,3797,3765,3779,3781,-41,-39,1576,8938.47 ,3358
20141024,3779,3781,3780,3789,3769,3789,3779,8,-2,872,4943.27 ,3380
20141027,3789,3779,3789,3794,3766,3768,3778,-11,-1,1200,6801.02 ,3338
20141028,3768,3778,3772,3786,3760,3773,3771,-5,-7,576,3258.29 ,3342
20141029,3773,3771,3796,3798,3771,3793,3786,22,15,1078,6122.62 ,3386
20141030,3793,3786,3774,3966,3701,3709,3764,-77,-22,2600,14681.86 ,3680
20141031,3709,3764,3667,3677,3575,3575,3634,-189,-130,6678,36405.20 ,4682
20141103,3575,3634,3506,3509,3430,3467,3475,-167,-159,4910,25599.67 ,4768
20141104,3467,3475,3477,3484,3448,3463,3473,-12,-2,4966,25870.82 ,4744
20141105,3463,3473,3443,3463,3321,3329,3417,-144,-56,7088,36332.29 ,4972
20141106,3329,3417,3298,3325,3262,3283,3289,-134,-128,5890,29066.94 ,5098
20141107,3283,3289,3288,3303,3213,3289,3269,0,-20,8070,39572.29 ,5326
20141110,3289,3269,3295,3407,3284,3371,3350,102,81,10386,52202.39 ,5078
20141111,3371,3350,3357,3378,3343,3351,3360,1,10,4032,20326.93 ,5092
20141112,3351,3360,3345,3398,3345,3389,3378,29,18,3464,17554.20 ,4990
20141113,3389,3378,3346,3397,3346,3379,3380,1,2,3426,17370.85 ,4850
20141114,3379,3380,3385,3404,3291,3310,3348,-70,-32,7888,39618.74 ,5522
20141117,3310,3348,3315,3515,3296,3482,3422,134,74,13036,66933.20 ,4694
20141118,3482,3422,3454,3492,3447,3472,3472,50,50,6416,33418.94 ,4372
20141119,3472,3472,3499,3499,3461,3476,3476,4,4,2922,15237.25 ,4328
20141120,3476,3476,3478,3540,3410,3454,3462,-22,-14,7240,37608.08 ,4206
20141121,3454,3462,3459,3475,3441,3475,3461,13,-1,2742,14236.89 ,4094
20141124,3475,3461,3496,3546,3490,3497,3515,36,54,4058,21396.32 ,4490
20141125,3497,3515,3485,3513,3481,3513,3498,-2,-17,2352,12344.28 ,4644
20141126,3513,3498,3519,3523,3482,3502,3500,4,2,3646,19141.61 ,4868
20141127,3502,3500,3498,3502,3436,3464,3469,-36,-31,3966,20638.64 ,4892
20141128,3464,3469,3464,3464,3407,3408,3429,-61,-40,3092,15907.46 ,4520
20141201,3408,3429,3406,3421,3257,3257,3338,-172,-91,4284,21451.67 ,4878
20141202,3257,3338,3331,3557,3330,3476,3439,138,101,16588,85581.81 ,4138
20141203,3476,3439,3439,3505,3422,3478,3476,39,37,11854,61821.01 ,3940
20141204,3478,3476,3475,3510,3470,3491,3490,15,14,5946,31129.11 ,3960
20141205,3491,3490,3494,3547,3461,3499,3508,9,18,7778,40933.82 ,3758
20141208,3499,3508,3497,3530,3440,3481,3481,-27,-27,7476,39036.12 ,3772
20141209,3481,3481,3480,3504,3455,3491,3478,10,-3,8898,46429.07 ,4020
20141210,3491,3478,3539,3651,3539,3651,3609,173,131,10864,58816.60 ,4334
20141211,3651,3609,3622,3719,3617,3635,3658,26,49,9732,53410.77 ,3884
20141212,3635,3658,3635,3667,3626,3642,3643,-16,-15,6158,33659.48 ,3836
20141215,3642,3643,3670,3670,3585,3630,3637,-13,-6,4704,25668.47 ,3878
20141216,3630,3637,3591,3617,3465,3470,3538,-167,-99,6788,36028.04 ,3670
20141217,3470,3538,3509,3560,3374,3434,3452,-104,-86,9452,48952.19 ,3416
20141218,3434,3452,3434,3485,3366,3467,3422,15,-30,7242,37177.50 ,3534
20141219,3467,3422,3468,3495,3437,3461,3468,39,46,3956,20580.75 ,3526
20141222,3461,3468,3459,3483,3448,3471,3467,3,-1,2384,12399.59 ,3680
20141223,3471,3467,3474,3474,3382,3402,3420,-65,-47,2044,10485.80 ,3722
20141224,3402,3420,3390,3443,3354,3403,3394,-17,-26,1940,9877.85 ,3740
20141225,3403,3394,3405,3406,3383,3388,3392,-6,-2,542,2757.75 ,3742
20141226,3388,3392,3389,3418,3385,3410,3407,18,15,1010,5161.77 ,3838
20141229,3410,3407,3447,3528,3418,3424,3429,17,22,1166,5998.82 ,3838
20141230,3424,3429,3414,3434,3360,3397,3399,-32,-30,2114,10778.77 ,4182
20141231,3397,3399,3388,3511,3388,3455,3465,56,66,2586,13441.70 ,4832
20140218,4476,4476,,,,4476,4476,0,0,0,0.00 ,0
20140219,4476,4476,4511,4545,4507,4524,4522,48,46,20,135.69 ,6
20140220,4524,4522,4535,4540,4468,4468,4512,-54,-10,12,81.22 ,8
20140221,4468,4512,,,,4502,4502,-10,-10,0,0.00 ,8
20140224,4502,4502,4463,4463,4463,4463,4463,-39,-39,2,13.39 ,10
20140225,4463,4463,4541,4541,4446,4497,4503,34,40,70,472.89 ,10
20140226,4497,4503,4501,4550,4488,4542,4533,39,30,76,516.76 ,48
20140227,4542,4533,4498,4498,4367,4382,4439,-151,-94,120,799.13 ,68
20140228,4382,4439,4416,4416,4397,4406,4407,-33,-32,16,105.79 ,62
20140303,4406,4407,4446,4446,4438,4441,4440,34,33,18,119.89 ,48
20140304,4441,4440,4464,4466,4459,4462,4461,22,21,30,200.78 ,28
20140305,4462,4461,4398,4401,4395,4396,4397,-65,-64,14,92.34 ,32
20140306,4396,4397,4399,4399,4381,4395,4395,-2,-2,14,92.30 ,32
20140307,4395,4395,4355,4439,4355,4439,4407,44,12,10,66.11 ,32
20140310,4439,4407,4349,4349,4246,4261,4281,-146,-126,96,616.48 ,36
20140311,4261,4281,4285,4297,4268,4297,4282,16,1,22,141.31 ,50
20140312,4297,4282,4312,4332,4265,4330,4316,48,34,816,5283.52 ,442
20140313,4330,4316,4336,4399,4327,4371,4369,55,53,18,117.96 ,444
20140314,4371,4369,4339,4339,4339,4339,4339,-30,-30,2,13.02 ,442
20140317,4339,4339,4460,4460,4375,4375,4405,36,66,16,105.72 ,440
20140318,4375,4405,4391,4391,4336,4336,4354,-69,-51,6,39.19 ,438
20140319,4336,4354,4266,4305,4266,4295,4287,-59,-67,28,180.07 ,446
20140320,4295,4287,4289,4296,4284,4285,4288,-2,1,8,51.46 ,448
20140321,4285,4288,4254,4260,4240,4256,4252,-32,-36,8,51.03 ,448
20140324,4256,4252,4261,4261,4229,4241,4241,-11,-11,26,165.40 ,450
20140325,4241,4241,4231,4231,4200,4204,4210,-37,-31,40,252.62 ,478
20140326,4204,4210,4225,4233,4218,4228,4225,18,15,30,190.16 ,472
20140327,4228,4225,4219,4219,4190,4194,4204,-31,-21,36,227.04 ,480
20140328,4194,4204,4195,4216,4195,4216,4206,12,2,20,126.20 ,474
20140331,4216,4206,4219,4224,4213,4213,4219,7,13,12,75.95 ,472
20140401,4213,4219,4211,4221,4199,4199,4212,-20,-7,16,101.09 ,466
20140402,4199,4212,4214,4214,4214,4214,4214,2,2,2,12.64 ,466
20140403,4214,4214,4227,4227,4207,4207,4220,-7,6,22,139.28 ,468
20140404,4207,4220,4206,4206,4206,4206,4206,-14,-14,2,12.62 ,468
20140408,4206,4206,4220,4220,4220,4220,4220,14,14,10,63.30 ,468
20140409,4220,4220,,,,4228,4228,8,8,0,0.00 ,468
20140410,4228,4228,4195,4235,4191,4235,4207,7,-21,30,189.33 ,478
20140411,4235,4207,4231,4231,4228,4228,4229,21,22,4,25.38 ,476
20140414,4228,4229,4239,4239,4232,4232,4236,3,7,6,38.13 ,480
20140415,4232,4236,4231,4236,4204,4206,4227,-30,-9,22,139.52 ,486
20140416,4206,4227,4139,4139,4113,4113,4127,-114,-100,12,74.30 ,492
20140417,4113,4127,4147,4147,4128,4128,4131,1,4,26,161.13 ,502
20140418,4128,4131,4121,4122,4107,4107,4112,-24,-19,412,2541.24 ,500
20140421,4107,4112,4100,4101,4045,4045,4067,-67,-45,32,195.22 ,508
20140422,4045,4067,4060,4083,4047,4070,4059,3,-8,16,97.43 ,506
20140423,4070,4059,4066,4074,4064,4064,4069,5,10,8,48.83 ,506
20140424,4064,4069,4072,4082,4072,4072,4077,3,8,12,73.39 ,506
20140425,4072,4077,4067,4162,4064,4106,4119,29,42,74,457.29 ,518
20140428,4106,4119,4127,4146,4127,4135,4137,16,18,8,49.65 ,520
20140429,4135,4137,4112,4117,4103,4117,4110,-20,-27,6,37.00 ,520
20140430,4117,4110,4091,4091,4082,4083,4087,-27,-23,12,73.57 ,520
20140505,4083,4087,4119,4119,4115,4119,4117,32,30,6,37.06 ,520
20140506,4119,4117,4105,4105,4105,4105,4105,-12,-12,2,12.32 ,520
20140507,4105,4105,,,,4126,4126,21,21,0,0.00 ,520
20140508,4126,4126,4105,4105,4069,4069,4083,-57,-43,12,73.50 ,520
20140509,4069,4083,4064,4064,4049,4056,4054,-27,-29,14,85.14 ,524
20140512,4056,4054,4077,4077,4077,4077,4077,23,23,4,24.46 ,524
20140513,4077,4077,4114,4134,4097,4097,4121,20,44,40,247.28 ,518
20140514,4097,4121,,,,4121,4121,0,0,0,0.00 ,518
20140515,4121,4121,4158,4158,4150,4150,4154,29,33,6,37.39 ,518
20140516,4150,4154,4110,4110,4099,4099,4106,-55,-48,6,36.95 ,522
20140519,4099,4106,4095,4118,4095,4118,4110,12,4,18,110.97 ,528
20140520,4118,4110,4101,4103,4095,4095,4100,-15,-10,14,86.10 ,536
20140521,4095,4100,4100,4125,4075,4121,4111,21,11,32,197.34 ,530
20140522,4121,4111,4113,4132,4108,4132,4121,21,10,12,74.18 ,530
20140523,4132,4121,4127,4127,4127,4127,4127,6,6,2,12.38 ,528
20140526,4127,4127,,,,4127,4127,0,0,0,0.00 ,528
20140527,4127,4127,4108,4108,4098,4098,4103,-29,-24,4,24.62 ,530
20140528,4098,4103,4080,4080,4059,4065,4065,-38,-38,68,414.69 ,566
20140529,4065,4065,4064,4068,4025,4033,4054,-32,-11,36,218.94 ,580
20140530,4033,4054,4027,4046,4027,4044,4033,-10,-21,416,2516.73 ,580
20140603,4044,4033,4011,4028,4011,4028,4023,-5,-10,14,84.49 ,568
20140604,4028,4023,4026,4042,4024,4040,4030,17,7,16,96.74 ,564
20140605,4040,4030,4050,4054,4036,4047,4050,17,20,196,1190.96 ,596
20140606,4047,4050,4070,4085,4068,4085,4073,35,23,10,61.11 ,598
20140609,4085,4073,4071,4071,4051,4064,4058,-9,-15,12,73.06 ,592
20140610,4064,4058,4059,4066,4058,4066,4061,8,3,6,36.55 ,590
20140611,4066,4061,,,,4062,4062,1,1,0,0.00 ,590
20140612,4062,4062,,,,4062,4062,0,0,0,0.00 ,590
20140613,4062,4062,4095,4133,4089,4133,4106,71,44,84,517.48 ,590
20140616,4133,4106,4116,4180,4108,4172,4137,66,31,84,521.38 ,570
20140617,4172,4137,4143,4143,4115,4124,4118,-13,-19,46,284.18 ,554
20140618,4124,4118,4133,4145,4129,4135,4134,17,16,22,136.43 ,546
20140619,4135,4134,4135,4176,4135,4166,4153,32,19,32,199.38 ,536
20140620,4166,4153,4194,4366,4194,4341,4296,188,143,126,812.06 ,538
20140623,4341,4296,4383,4396,4360,4378,4392,82,96,188,1238.59 ,618
20140624,4378,4392,4370,4391,4351,4366,4361,-26,-31,56,366.34 ,616
20140625,4366,4361,4376,4396,4324,4346,4357,-15,-4,48,313.71 ,612
20140626,4346,4357,4366,4371,4351,4351,4364,-6,7,28,183.29 ,610
20140627,4351,4364,4365,4374,4365,4368,4369,4,5,16,104.87 ,606
20140630,4368,4369,4375,4375,4324,4336,4347,-33,-22,26,169.55 ,616
20140701,4336,4347,4333,4366,4333,4350,4355,3,8,30,196.01 ,608
20140702,4350,4355,4355,4355,4341,4341,4345,-14,-10,28,182.51 ,584
20140703,4341,4345,4358,4368,4332,4332,4351,-13,6,26,169.69 ,582
20140704,4332,4351,4342,4343,4342,4343,4342,-8,-9,8,52.11 ,576
20140707,4343,4342,4340,4340,4278,4296,4324,-46,-18,60,389.20 ,546
20140708,4296,4324,4296,4322,4296,4322,4313,-2,-11,64,414.08 ,516
20140709,4322,4313,4327,4344,4314,4330,4338,17,25,218,1418.75 ,628
20140710,4330,4338,4329,4368,4329,4344,4351,6,13,12,78.33 ,622
20140711,4344,4351,4400,4425,4400,4417,4414,66,63,6,39.73 ,622
20140714,4417,4414,4417,4417,4378,4378,4401,-36,-13,12,79.22 ,620
20140715,4378,4401,4344,4344,4325,4339,4339,-62,-62,28,182.24 ,618
20140716,4339,4339,4347,4347,4302,4305,4328,-34,-11,16,103.89 ,618
20140717,4305,4328,,,,4328,4328,0,0,0,0.00 ,618
20140718,4328,4328,4328,4365,4328,4364,4362,36,34,30,196.31 ,618
20140721,4364,4362,4330,4339,4314,4339,4327,-23,-35,12,77.90 ,618
20140722,4339,4327,,,,4336,4336,9,9,0,0.00 ,618
20140723,4336,4336,4355,4365,4345,4350,4350,14,14,52,339.32 ,612
20140724,4350,4350,4356,4356,4326,4328,4340,-22,-10,8,52.08 ,610
20140725,4328,4340,4325,4325,4282,4287,4301,-53,-39,34,219.38 ,618
20140728,4287,4301,4306,4315,4306,4315,4311,14,10,18,116.42 ,610
20140729,4315,4311,4308,4316,4308,4316,4311,5,0,42,271.65 ,610
20140730,4316,4311,4300,4302,4300,4302,4301,-9,-10,6,38.71 ,610
20140731,4302,4301,4307,4310,4300,4310,4304,9,3,8,51.65 ,612
20140801,4310,4304,4303,4303,4298,4299,4300,-5,-4,8,51.60 ,614
20140804,4299,4300,4309,4320,4309,4320,4314,20,14,4,25.89 ,612
20140805,4320,4314,4296,4296,4267,4286,4284,-28,-30,24,154.22 ,610
20140806,4286,4284,4268,4268,4223,4226,4232,-58,-52,388,2463.24 ,440
20140807,4226,4232,4246,4246,4233,4243,4242,11,10,100,636.38 ,384
20140808,4243,4242,4228,4257,4228,4256,4243,14,1,74,471.03 ,346
20140811,4256,4243,,,,4232,4232,-11,-11,0,0.00 ,346
20140812,4232,4232,,,,4232,4232,0,0,0,0.00 ,346
20140813,4232,4232,,,,4233,4233,1,1,0,0.00 ,346
20140814,4233,4233,4215,4215,4215,4215,4215,-18,-18,2,12.65 ,344
20140815,4215,4215,4222,4223,4212,4212,4220,-3,5,14,88.63 ,344
20140818,4212,4220,4165,4192,4128,4143,4172,-77,-48,440,2753.75 ,328
20140819,4143,4172,4143,4143,4125,4125,4136,-47,-36,14,86.87 ,334
20140820,4125,4136,4104,4104,4091,4091,4096,-45,-40,6,36.86 ,336
20140821,4091,4096,4096,4096,4096,4096,4096,0,0,2,12.29 ,334
20140822,4096,4096,4100,4114,4100,4111,4108,15,12,22,135.59 ,342
20140825,4111,4108,4116,4116,4112,4112,4112,4,4,32,197.39 ,366
20140826,4112,4112,4116,4116,4113,4113,4115,1,3,68,419.75 ,366
20140827,4113,4115,4150,4150,4120,4120,4136,5,21,6,37.23 ,366
20140828,4120,4136,4136,4162,4136,4160,4158,24,22,54,336.86 ,414
20140829,4160,4158,4152,4152,4121,4121,4139,-37,-19,146,906.47 ,524
20140901,4121,4139,4134,4134,4105,4108,4123,-31,-16,52,321.67 ,522
20140902,4108,4123,4108,4108,4090,4090,4099,-33,-24,28,172.19 ,524
20140903,4090,4099,4077,4078,4066,4078,4074,-21,-25,44,268.93 ,530
20140904,4078,4074,4073,4085,4072,4084,4079,10,5,18,110.14 ,534
20140905,4084,4079,4100,4100,4072,4072,4076,-7,-3,24,146.77 ,532
20140909,4072,4076,4065,4065,4065,4065,4065,-11,-11,2,12.20 ,532
20140910,4065,4065,4043,4072,4043,4072,4057,7,-8,4,24.35 ,530
20140911,4072,4057,4050,4050,4044,4044,4046,-13,-11,6,36.42 ,530
20140912,4044,4046,4022,4022,3992,3992,4007,-54,-39,4,24.04 ,530
20140915,3992,4007,4011,4012,4011,4012,4011,5,4,10,60.17 ,528
20140916,4012,4011,4037,4037,4037,4037,4037,26,26,2,12.11 ,530
20140917,4037,4037,4037,4037,4037,4037,4037,0,0,4,24.22 ,530
20140918,4037,4037,4020,4036,4007,4007,4021,-30,-16,6,36.19 ,528
20140919,4007,4021,4014,4024,4013,4013,4017,-8,-4,6,36.15 ,528
20140922,4013,4017,3902,3902,3775,3775,3817,-242,-200,32,183.24 ,532
20140923,3775,3817,3780,3789,3741,3775,3774,-42,-43,76,430.30 ,520
20140924,3775,3774,3774,3774,3774,3774,3774,0,0,6,33.97 ,518
20140925,3774,3774,3745,3745,3745,3745,3745,-29,-29,2,11.24 ,516
20140926,3745,3745,3736,3808,3703,3799,3741,54,-4,32,179.58 ,524
20140929,3799,3741,3767,3791,3761,3781,3772,40,31,26,147.14 ,520
20140930,3781,3772,3804,3804,3774,3774,3786,2,14,16,90.86 ,508
20141008,3774,3786,,,,3779,3779,-7,-7,0,0.00 ,508
20141009,3779,3779,3772,3797,3742,3797,3772,18,-7,14,79.22 ,510
20141010,3797,3772,3793,3793,3782,3782,3786,10,14,6,34.08 ,510
20141013,3782,3786,3783,3845,3783,3828,3809,42,23,30,171.44 ,514
20141014,3828,3809,3807,3829,3802,3815,3814,6,5,42,240.31 ,498
20141015,3815,3814,3830,3830,3774,3774,3785,-40,-29,34,193.08 ,486
20141016,3774,3785,3796,3811,3796,3806,3803,21,18,12,68.46 ,488
20141017,3806,3803,3782,3807,3782,3805,3796,2,-7,22,125.29 ,486
20141020,3805,3796,3795,3809,3795,3809,3805,13,9,8,45.67 ,484
20141021,3809,3805,3813,3817,3806,3806,3810,1,5,8,45.73 ,484
20141022,3806,3810,3826,3827,3826,3826,3826,16,16,22,126.26 ,486
20141023,3826,3826,3806,3806,3761,3767,3781,-59,-45,16,90.74 ,480
20141024,3767,3781,3769,3769,3760,3769,3765,-12,-16,10,56.49 ,478
20141027,3769,3765,3764,3764,3764,3764,3764,-1,-1,2,11.29 ,478
20141028,3764,3764,3750,3781,3750,3775,3770,11,6,10,56.56 ,476
20141029,3775,3770,3782,3782,3777,3777,3779,7,9,8,45.35 ,480
20141030,3777,3779,3775,3775,3701,3701,3736,-78,-43,40,224.19 ,486
20141031,3701,3736,3655,3655,3549,3574,3599,-162,-137,98,529.08 ,466
20141103,3574,3599,3477,3502,3420,3464,3468,-135,-131,202,1050.86 ,450
20141104,3464,3468,3466,3470,3441,3452,3455,-16,-13,48,248.79 ,444
20141105,3452,3455,3437,3447,3314,3314,3393,-141,-62,54,274.88 ,454
20141106,3314,3393,3258,3306,3243,3274,3273,-119,-120,54,265.16 ,442
20141107,3274,3273,3264,3283,3192,3275,3250,2,-23,66,321.80 ,426
20141110,3275,3250,3279,3382,3279,3367,3320,117,70,130,647.53 ,442
20141111,3367,3320,3353,3355,3330,3340,3341,20,21,88,441.12 ,480
20141112,3340,3341,3340,3376,3340,3363,3359,22,18,6,30.24 ,480
20141113,3363,3359,3370,3374,3355,3358,3361,-1,2,34,171.43 ,466
20141114,3358,3361,3363,3363,3287,3287,3319,-74,-42,28,139.42 ,474
20141117,3287,3319,3258,3484,3258,3469,3398,150,79,122,622.00 ,480
20141118,3469,3398,3451,3477,3442,3455,3454,57,56,28,145.08 ,478
20141119,3455,3454,3475,3476,3445,3461,3461,7,7,22,114.22 ,474
20141120,3461,3461,3468,3512,3356,3426,3434,-35,-27,44,226.67 ,482
20141121,3426,3434,3443,3455,3443,3455,3451,21,17,14,72.48 ,474
20141124,3455,3451,3482,3505,3476,3489,3489,38,38,16,83.75 ,466
20141125,3489,3489,3480,3497,3480,3488,3485,-1,-4,18,94.12 ,470
20141126,3488,3485,3500,3500,3488,3492,3494,7,9,20,104.85 ,470
20141127,3492,3494,3481,3485,3426,3453,3458,-41,-36,118,612.22 ,466
20141128,3453,3458,3441,3442,3395,3396,3409,-62,-49,76,388.67 ,456
20141201,3396,3409,3388,3388,3238,3238,3267,-171,-142,116,568.54 ,518
20141202,3238,3267,3263,3527,3263,3461,3406,194,139,814,4159.22 ,536
20141203,3461,3406,3433,3488,3433,3455,3466,49,60,146,759.10 ,528
20141204,3455,3466,3474,3495,3472,3480,3482,14,16,48,250.77 ,536
20141205,3480,3482,3508,3508,3463,3491,3495,9,13,334,1751.31 ,618
20141208,3491,3495,3522,3528,3448,3466,3472,-29,-23,670,3489.99 ,592
20141209,3466,3472,3454,3507,3450,3507,3485,35,13,52,271.84 ,580
20141210,3507,3485,3550,3659,3550,3659,3610,174,125,142,769.12 ,558
20141211,3659,3610,3663,3717,3618,3640,3673,30,63,448,2468.91 ,544
20141212,3640,3673,3651,3672,3630,3652,3651,-21,-22,148,810.53 ,506
20141215,3652,3651,3669,3673,3613,3642,3648,-9,-3,134,733.31 ,480
20141216,3642,3648,3619,3619,3481,3492,3502,-156,-146,250,1313.29 ,552
20141217,3492,3502,3543,3543,3411,3426,3475,-76,-27,140,729.90 ,552
20141218,3426,3475,3414,3474,3401,3471,3441,-4,-34,182,939.41 ,602
20141219,3471,3441,3455,3500,3450,3462,3475,21,34,184,959.37 ,622
20141222,3462,3475,3461,3492,3430,3481,3473,6,-2,134,698.11 ,626
20141223,3481,3473,3478,3480,3405,3406,3432,-67,-41,78,401.59 ,614
20141224,3406,3432,3401,3430,3401,3420,3410,-12,-22,74,378.61 ,624
20141225,3420,3410,3411,3421,3400,3405,3404,-5,-6,232,1184.81 ,788
20141226,3405,3404,3408,3440,3408,3427,3429,23,25,142,730.52 ,856
20141229,3427,3429,3440,3449,3424,3441,3438,12,9,176,907.85 ,876
20141230,3441,3438,3435,3447,3381,3408,3402,-30,-36,156,796.17 ,934
20141231,3408,3402,3435,3517,3435,3467,3467,65,65,48,249.67 ,926
20140318,4405,4405,,,,4390,4390,-15,-15,0,0.00 ,0
20140319,4390,4390,4302,4302,4302,4302,4302,-88,-88,2,12.91 ,2
20140320,4302,4302,4291,4324,4291,4300,4305,-2,3,6,38.75 ,4
20140321,4300,4305,,,,4269,4269,-36,-36,0,0.00 ,4
20140324,4269,4269,,,,4269,4269,0,0,0,0.00 ,4
20140325,4269,4269,4253,4253,4216,4226,4229,-43,-40,18,114.19 ,10
20140326,4226,4229,4222,4231,4222,4231,4226,2,-3,4,25.36 ,12
20140327,4231,4226,4223,4228,4203,4220,4218,-6,-8,10,63.28 ,18
20140328,4220,4218,4198,4225,4195,4225,4218,7,0,94,594.82 ,82
20140331,4225,4218,4234,4234,4220,4220,4227,2,9,4,25.36 ,82
20140401,4220,4227,4219,4226,4193,4205,4205,-22,-22,22,138.80 ,90
20140402,4205,4205,4205,4205,4205,4205,4205,0,0,2,12.62 ,92
20140403,4205,4205,,,,4207,4207,2,2,0,0.00 ,92
20140404,4207,4207,4210,4210,4210,4210,4210,3,3,2,12.63 ,94
20140408,4210,4210,4230,4250,4230,4250,4235,40,25,18,114.36 ,102
20140409,4250,4235,4233,4233,4233,4233,4233,-2,-2,2,12.70 ,102
20140410,4233,4233,4199,4247,4199,4247,4216,14,-17,46,290.94 ,102
20140411,4247,4216,,,,4222,4222,6,6,0,0.00 ,102
20140414,4222,4222,4238,4238,4238,4238,4238,16,16,4,25.43 ,106
20140415,4238,4238,4240,4240,4200,4200,4215,-38,-23,22,139.11 ,110
20140416,4200,4215,4148,4148,4129,4129,4135,-86,-80,22,136.47 ,126
20140417,4129,4135,4146,4146,4115,4115,4126,-20,-9,6,37.14 ,126
20140418,4115,4126,4127,4127,4109,4109,4119,-17,-7,12,74.15 ,130
20140421,4109,4119,4114,4114,4046,4055,4054,-64,-65,264,1605.56 ,336
20140422,4055,4054,4063,4063,4048,4055,4055,1,1,16,97.33 ,342
20140423,4055,4055,4069,4082,4068,4068,4073,13,18,6,36.66 ,346
20140424,4068,4073,4080,4091,4079,4079,4086,6,13,16,98.08 ,352
20140425,4079,4086,4070,4160,4065,4111,4109,25,23,100,616.48 ,384
20140428,4111,4109,4132,4153,4132,4137,4146,28,37,24,149.29 ,384
20140429,4137,4146,4118,4118,4108,4108,4113,-38,-33,12,74.03 ,384
20140430,4108,4113,4106,4106,4088,4088,4093,-25,-20,32,196.49 ,414
20140505,4088,4093,4112,4120,4112,4120,4119,27,26,34,210.09 ,446
20140506,4120,4119,4140,4140,4118,4118,4127,-1,8,12,74.30 ,448
20140507,4118,4127,4132,4141,4132,4141,4136,14,9,4,24.82 ,446
20140508,4141,4136,4110,4110,4070,4070,4076,-66,-60,48,293.54 ,448
20140509,4070,4076,4060,4064,4050,4064,4054,-12,-22,34,206.79 ,464
20140512,4064,4054,4070,4090,4066,4084,4076,30,22,14,85.60 ,464
20140513,4084,4076,4120,4141,4109,4109,4133,33,57,68,421.66 ,484
20140514,4109,4133,4120,4120,4120,4120,4120,-13,-13,4,24.72 ,484
20140515,4120,4120,4169,4169,4141,4144,4147,24,27,66,410.60 ,514
20140516,4144,4147,4126,4132,4097,4097,4120,-50,-27,52,321.38 ,540
20140519,4097,4120,4108,4128,4094,4124,4110,4,-10,30,184.96 ,534
20140520,4124,4110,4108,4138,4097,4097,4109,-13,-1,30,184.91 ,540
20140521,4097,4109,4109,4129,4109,4123,4120,14,11,8,49.45 ,538
20140522,4123,4120,4123,4137,4123,4132,4130,12,10,6,37.18 ,538
20140523,4132,4130,4146,4146,4127,4129,4132,-1,2,12,74.39 ,546
20140526,4129,4132,4137,4137,4124,4134,4127,2,-5,14,86.67 ,548
20140527,4134,4127,4125,4133,4097,4097,4102,-30,-25,48,295.37 ,572
20140528,4097,4102,4097,4097,4058,4072,4064,-30,-38,150,914.60 ,668
20140529,4072,4064,4073,4073,4025,4025,4060,-39,-4,70,426.35 ,664
20140530,4025,4060,4032,4056,4029,4056,4050,-4,-10,88,534.61 ,674
20140603,4056,4050,4030,4040,4030,4040,4035,-10,-15,4,24.21 ,678
20140604,4040,4035,4040,4050,4040,4046,4044,11,9,10,60.67 ,674
20140605,4046,4044,4052,4055,4052,4055,4053,11,9,4,24.32 ,676
20140606,4055,4053,4063,4092,4063,4092,4072,39,19,66,403.13 ,678
20140609,4092,4072,4082,4082,4046,4061,4061,-11,-11,28,170.60 ,682
20140610,4061,4061,4058,4058,4058,4058,4058,-3,-3,2,12.17 ,682
20140611,4058,4058,4080,4082,4076,4079,4079,21,21,8,48.95 ,680
20140612,4079,4079,,,,4079,4079,0,0,0,0.00 ,680
20140613,4079,4079,4083,4126,4083,4126,4100,47,21,54,332.14 ,698
20140616,4126,4100,4118,4182,4118,4173,4149,73,49,94,585.11 ,724
20140617,4173,4149,4159,4160,4126,4126,4153,-23,4,14,87.22 ,714
20140618,4126,4153,4136,4145,4136,4145,4140,-8,-13,6,37.26 ,712
20140619,4145,4140,4143,4172,4143,4172,4159,32,19,16,99.83 ,712
20140620,4172,4159,4196,4366,4196,4350,4276,191,117,64,410.57 ,722
20140623,4350,4276,4353,4443,4346,4383,4380,107,104,212,1393.02 ,812
20140624,4383,4380,4375,4375,4347,4370,4356,-10,-24,78,509.68 ,818
20140625,4370,4356,4376,4401,4331,4358,4356,2,0,118,771.17 ,816
20140626,4358,4356,4388,4392,4359,4359,4376,3,20,32,210.07 ,808
20140627,4359,4376,4362,4390,4360,4390,4370,14,-6,34,222.88 ,796
20140630,4390,4370,4367,4367,4334,4336,4344,-34,-26,8,52.13 ,800
20140701,4336,4344,4334,4374,4334,4372,4360,28,16,16,104.64 ,798
20140702,4372,4360,4366,4366,4356,4356,4361,-4,1,6,39.25 ,796
20140703,4356,4361,4368,4377,4357,4357,4367,-4,6,8,52.40 ,794
20140704,4357,4367,4345,4357,4345,4357,4348,-10,-19,8,52.18 ,796
20140707,4357,4348,4368,4368,4300,4311,4336,-37,-12,48,312.20 ,822
20140708,4311,4336,4308,4333,4308,4333,4328,-3,-8,22,142.84 ,818
20140709,4333,4328,4332,4354,4328,4342,4342,14,14,22,143.32 ,826
20140710,4342,4342,4345,4364,4324,4361,4356,19,14,28,182.95 ,834
20140711,4361,4356,4425,4427,4417,4427,4422,71,66,12,79.60 ,828
20140714,4427,4422,4404,4404,4379,4379,4395,-43,-27,8,52.75 ,830
20140715,4379,4395,4347,4354,4339,4354,4344,-41,-51,36,234.59 ,832
20140716,4354,4344,4313,4326,4312,4313,4317,-31,-27,30,194.29 ,834
20140717,4313,4317,4333,4333,4325,4325,4326,8,9,16,103.83 ,830
20140718,4325,4326,4360,4372,4359,4370,4364,44,38,18,117.83 ,816
20140721,4370,4364,4341,4345,4327,4343,4336,-21,-28,16,104.08 ,818
20140722,4343,4336,,,,4342,4342,6,6,0,0.00 ,818
20140723,4342,4342,4375,4375,4355,4358,4364,16,22,10,65.46 ,820
20140724,4358,4364,4350,4350,4334,4336,4342,-28,-22,86,560.19 ,802
20140725,4336,4342,4333,4333,4297,4297,4301,-45,-41,22,141.95 ,796
20140728,4297,4301,4302,4327,4302,4327,4310,26,9,6,38.80 ,796
20140729,4327,4310,,,,4317,4317,7,7,0,0.00 ,796
20140730,4317,4317,,,,4317,4317,0,0,0,0.00 ,796
20140731,4317,4317,,,,4317,4317,0,0,0,0.00 ,796
20140801,4317,4317,4300,4304,4297,4298,4299,-19,-18,44,283.77 ,804
20140804,4298,4299,4331,4331,4305,4305,4318,6,19,4,25.91 ,802
20140805,4305,4318,4302,4302,4280,4300,4291,-18,-27,30,193.12 ,802
20140806,4300,4291,4273,4273,4225,4228,4236,-63,-55,258,1639.51 ,676
20140807,4228,4236,4248,4249,4241,4245,4246,9,10,74,471.35 ,654
20140808,4245,4246,4232,4259,4232,4256,4246,10,0,84,535.05 ,654
20140811,4256,4246,4233,4233,4231,4231,4231,-15,-15,24,152.33 ,630
20140812,4231,4231,,,,4223,4223,-8,-8,0,0.00 ,630
20140813,4223,4223,4228,4228,4228,4228,4228,5,5,2,12.68 ,630
20140814,4228,4228,4208,4235,4208,4217,4220,-11,-8,10,63.31 ,630
20140815,4217,4220,4218,4218,4218,4218,4218,-2,-2,2,12.65 ,632
20140818,4218,4218,4166,4190,4124,4137,4163,-81,-55,630,3934.42 ,604
20140819,4137,4163,4137,4163,4135,4136,4146,-27,-17,76,472.66 ,604
20140820,4136,4146,4113,4119,4077,4105,4091,-41,-55,80,490.97 ,590
20140821,4105,4091,4120,4120,4094,4094,4111,3,20,6,37.00 ,594
20140822,4094,4111,4113,4113,4113,4113,4113,2,2,2,12.34 ,594
20140825,4113,4113,4114,4120,4110,4116,4116,3,3,18,111.14 ,598
20140826,4116,4116,4117,4139,4116,4139,4120,23,4,48,296.64 ,596
20140827,4139,4120,4122,4127,4117,4119,4120,-1,0,14,86.54 ,594
20140828,4119,4120,4133,4161,4133,4161,4147,41,27,12,74.66 ,596
20140829,4161,4147,4167,4167,4136,4137,4141,-10,-6,58,360.31 ,644
20140901,4137,4141,4135,4135,4114,4114,4118,-27,-23,14,86.49 ,656
20140902,4114,4118,4100,4100,4095,4095,4097,-23,-21,4,24.59 ,654
20140903,4095,4097,4078,4078,4078,4078,4078,-19,-19,2,12.23 ,656
20140904,4078,4078,,,,4078,4078,0,0,0,0.00 ,656
20140905,4078,4078,4060,4072,4055,4055,4062,-23,-16,112,682.49 ,630
20140909,4055,4062,4048,4067,4024,4024,4051,-38,-11,26,157.99 ,630
20140910,4024,4051,4030,4053,4030,4051,4044,0,-7,12,72.80 ,628
20140911,4051,4044,4042,4042,4037,4037,4039,-7,-5,12,72.71 ,620
20140912,4037,4039,4012,4012,3981,3999,3992,-40,-47,74,443.11 ,600
20140915,3999,3992,,,,3992,3992,0,0,0,0.00 ,600
20140916,3992,3992,,,,4017,4017,25,25,0,0.00 ,600
20140917,4017,4017,,,,4021,4021,4,4,0,0.00 ,600
20140918,4021,4021,4036,4039,4006,4012,4024,-9,3,22,132.82 ,594
20140919,4012,4024,4020,4020,4020,4020,4020,-4,-4,8,48.24 ,586
20140922,4020,4020,3914,3914,3780,3793,3801,-227,-219,32,182.45 ,566
20140923,3793,3801,3734,3805,3734,3780,3781,-21,-20,220,1247.81 ,594
20140924,3780,3781,3793,3816,3774,3807,3795,26,14,68,387.12 ,596
20140925,3807,3795,3751,3778,3716,3728,3743,-67,-52,78,438.02 ,600
20140926,3728,3743,3740,3817,3740,3790,3784,47,41,12,68.12 ,608
20140929,3790,3784,3782,3803,3777,3803,3784,19,0,20,113.52 ,610
20140930,3803,3784,3781,3804,3770,3770,3791,-14,7,14,79.63 ,606
20141008,3770,3791,3753,3755,3737,3749,3748,-42,-43,24,134.93 ,608
20141009,3749,3748,3756,3793,3731,3793,3763,45,15,24,135.50 ,600
20141010,3793,3763,3800,3815,3776,3776,3803,13,40,38,216.82 ,610
20141013,3776,3803,3790,3825,3790,3825,3809,22,6,8,45.71 ,606
20141014,3825,3809,3805,3805,3805,3805,3805,-4,-4,2,11.42 ,606
20141015,3805,3805,3824,3824,3775,3777,3791,-28,-14,10,56.87 ,608
20141016,3777,3791,3796,3796,3796,3796,3796,5,5,4,22.78 ,606
20141017,3796,3796,3790,3793,3790,3793,3791,-3,-5,4,22.75 ,602
20141020,3793,3791,,,,3791,3791,0,0,0,0.00 ,602
20141021,3791,3791,3791,3801,3782,3801,3793,10,2,30,170.71 ,596
20141022,3801,3793,3809,3809,3809,3809,3809,16,16,2,11.43 ,596
20141023,3809,3809,3767,3775,3762,3772,3767,-37,-42,46,259.93 ,590
20141024,3772,3767,3760,3765,3760,3765,3763,-2,-4,8,45.16 ,584
20141027,3765,3763,3781,3794,3753,3765,3770,2,7,50,282.77 ,576
20141028,3765,3770,3757,3770,3757,3768,3765,-2,-5,6,33.89 ,578
20141029,3768,3765,3770,3770,3770,3770,3770,5,5,2,11.31 ,580
20141030,3770,3770,3770,3770,3693,3717,3711,-53,-59,36,200.44 ,584
20141031,3717,3711,3664,3664,3526,3536,3592,-175,-119,222,1196.16 ,654
20141103,3536,3592,3519,3519,3420,3442,3456,-150,-136,390,2021.85 ,674
20141104,3442,3456,3452,3452,3428,3428,3442,-28,-14,50,258.17 ,682
20141105,3428,3442,3435,3440,3294,3319,3393,-123,-49,82,417.43 ,662
20141106,3319,3393,3256,3277,3231,3274,3257,-119,-136,200,977.12 ,640
20141107,3274,3257,3263,3263,3180,3263,3220,6,-37,208,1004.85 ,664
20141110,3263,3220,3276,3380,3276,3352,3322,132,102,342,1704.69 ,682
20141111,3352,3322,3320,3337,3320,3331,3329,9,7,38,189.78 ,684
20141112,3331,3329,3337,3377,3337,3369,3360,40,31,26,131.06 ,692
20141113,3369,3360,3365,3371,3354,3354,3362,-6,2,10,50.44 ,696
20141114,3354,3362,3374,3374,3261,3266,3325,-96,-37,80,399.09 ,708
20141117,3266,3325,3270,3491,3261,3455,3446,130,121,148,765.04 ,690
20141118,3455,3446,3435,3464,3431,3443,3443,-3,-3,30,154.96 ,682
20141119,3443,3443,3456,3460,3441,3446,3456,3,13,134,694.67 ,652
20141120,3446,3456,3412,3422,3408,3422,3416,-34,-40,26,133.22 ,656
20141121,3422,3416,3433,3433,3433,3433,3433,17,17,10,51.50 ,666
20141124,3433,3433,3487,3500,3477,3477,3490,44,57,8,41.88 ,664
20141125,3477,3490,3476,3476,3468,3470,3470,-20,-20,38,197.84 ,678
20141126,3470,3470,3470,3475,3458,3463,3467,-7,-3,58,301.71 ,674
20141127,3463,3467,3466,3471,3426,3445,3442,-22,-25,98,506.00 ,680
20141128,3445,3442,3437,3437,3381,3389,3414,-53,-28,32,163.88 ,660
20141201,3389,3414,3376,3376,3243,3243,3251,-171,-163,130,634.01 ,754
20141202,3243,3251,3301,3511,3301,3482,3423,231,172,332,1704.93 ,688
20141203,3482,3423,3482,3488,3419,3452,3449,29,26,82,424.26 ,678
20141204,3452,3449,3488,3493,3478,3482,3487,33,38,20,104.62 ,676
20141205,3482,3487,3500,3540,3471,3500,3498,13,11,46,241.39 ,680
20141208,3500,3498,3506,3506,3461,3465,3472,-33,-26,88,458.31 ,644
20141209,3465,3472,3457,3640,3454,3469,3504,-3,32,154,809.54 ,638
20141210,3469,3504,3574,3679,3572,3663,3640,159,136,242,1321.51 ,658
20141211,3663,3640,3665,3715,3627,3633,3673,-7,33,272,1498.62 ,632
20141212,3633,3673,3639,3656,3623,3656,3639,-17,-34,34,185.62 ,648
20141215,3656,3639,3670,3672,3601,3636,3628,-3,-11,98,533.36 ,652
20141216,3636,3628,3618,3623,3487,3503,3540,-125,-88,40,212.42 ,644
20141217,3503,3540,3548,3548,3430,3442,3465,-98,-75,130,675.80 ,710
20141218,3442,3465,3424,3446,3402,3446,3424,-19,-41,54,277.37 ,712
20141219,3446,3424,3484,3508,3450,3458,3471,34,47,118,614.45 ,678
20141222,3458,3471,3451,3457,3451,3457,3454,-14,-17,4,20.72 ,680
20141223,3457,3454,3475,3476,3399,3413,3433,-41,-21,92,473.79 ,664
20141224,3413,3433,3383,3451,3383,3424,3421,-9,-12,70,359.30 ,668
20141225,3424,3421,3411,3419,3407,3407,3411,-14,-10,12,61.41 ,664
20141226,3407,3411,3443,3451,3432,3451,3440,40,29,52,268.34 ,700
20141229,3451,3440,3465,3465,3427,3451,3455,11,15,52,269.51 ,736
20141230,3451,3455,3442,3461,3405,3416,3433,-39,-22,202,1040.47 ,866
20141231,3416,3433,3428,3528,3428,3479,3462,46,29,184,955.59 ,870
20140416,4215,4215,,,,4215,4215,0,0,0,0.00 ,0
20140417,4215,4215,,,,4215,4215,0,0,0,0.00 ,0
20140418,4215,4215,,,,4215,4215,0,0,0,0.00 ,0
20140421,4215,4215,4104,4121,4046,4064,4094,-151,-121,18,110.54 ,2
20140422,4064,4094,4067,4079,4052,4079,4059,-15,-35,46,280.08 ,2
20140423,4079,4059,4075,4080,4064,4064,4073,5,14,6,36.66 ,6
20140424,4064,4073,,,,4083,4083,10,10,0,0.00 ,6
20140425,4083,4083,4057,4152,4057,4116,4126,33,43,38,235.21 ,18
20140428,4116,4126,4143,4150,4138,4138,4143,12,17,6,37.29 ,18
20140429,4138,4143,4128,4128,4112,4112,4114,-31,-29,28,172.82 ,34
20140430,4112,4114,4103,4108,4088,4093,4099,-21,-15,30,184.49 ,34
20140505,4093,4099,4099,4133,4099,4125,4121,26,22,14,86.56 ,42
20140506,4125,4121,4124,4131,4124,4131,4127,10,6,6,37.15 ,42
20140507,4131,4127,4145,4145,4145,4145,4145,18,18,2,12.44 ,42
20140508,4145,4145,4102,4102,4075,4076,4085,-69,-60,16,98.05 ,40
20140509,4076,4085,4073,4073,4048,4058,4054,-27,-31,62,377.09 ,90
20140512,4058,4054,4066,4093,4050,4093,4066,39,12,44,268.36 ,88
20140513,4093,4066,4126,4143,4096,4096,4131,30,65,44,272.66 ,94
20140514,4096,4131,4125,4127,4125,4127,4125,-4,-6,6,37.13 ,94
20140515,4127,4125,4169,4169,4141,4141,4156,16,31,18,112.23 ,96
20140516,4141,4156,4132,4132,4103,4107,4113,-49,-43,26,160.44 ,108
20140519,4107,4113,4122,4126,4122,4126,4123,13,10,6,37.11 ,108
20140520,4126,4123,4131,4131,4107,4111,4120,-12,-3,10,61.80 ,106
20140521,4111,4120,,,,4120,4120,0,0,0,0.00 ,106
20140522,4120,4120,4130,4140,4130,4137,4136,17,16,10,62.05 ,108
20140523,4137,4136,4148,4148,4132,4132,4140,-4,4,8,49.68 ,112
20140526,4132,4140,4142,4142,4132,4136,4136,-4,-4,22,136.50 ,106
20140527,4136,4136,4126,4126,4123,4123,4124,-13,-12,4,24.75 ,104
20140528,4123,4124,4093,4093,4070,4072,4075,-52,-49,56,342.33 ,146
20140529,4072,4075,4033,4033,4033,4033,4033,-42,-42,4,24.20 ,148
20140530,4033,4033,4049,4053,4047,4047,4050,14,17,8,48.61 ,148
20140603,4047,4050,4010,4010,4010,4010,4010,-40,-40,2,12.03 ,150
20140604,4010,4010,4010,4065,4010,4041,4042,31,32,48,291.02 ,158
20140605,4041,4042,4055,4055,4043,4044,4044,2,2,28,169.87 ,160
20140606,4044,4044,4081,4081,4079,4079,4080,35,36,8,48.97 ,168
20140609,4079,4080,,,,4074,4074,-6,-6,0,0.00 ,168
20140610,4074,4074,,,,4073,4073,-1,-1,0,0.00 ,168
20140611,4073,4073,4080,4080,4080,4080,4080,7,7,2,12.24 ,168
20140612,4080,4080,4087,4087,4087,4087,4087,7,7,2,12.26 ,166
20140613,4087,4087,4087,4126,4087,4126,4112,39,25,12,74.02 ,164
20140616,4126,4112,4138,4180,4138,4180,4171,68,59,104,650.81 ,250
20140617,4180,4171,4157,4157,4128,4128,4143,-43,-28,40,248.60 ,224
20140618,4128,4143,4158,4158,4143,4143,4152,0,9,16,99.65 ,224
20140619,4143,4152,4149,4184,4149,4178,4163,26,11,18,112.41 ,220
20140620,4178,4163,4214,4379,4214,4350,4313,187,150,62,401.18 ,202
20140623,4350,4313,4390,4394,4355,4370,4379,57,66,32,210.20 ,194
20140624,4370,4379,4379,4379,4351,4368,4363,-11,-16,76,497.47 ,212
20140625,4368,4363,4401,4402,4334,4346,4372,-17,9,32,209.90 ,200
20140626,4346,4372,4369,4388,4369,4388,4378,16,6,4,26.27 ,202
20140627,4388,4378,,,,4378,4378,0,0,0,0.00 ,202
20140630,4378,4378,4387,4387,4337,4343,4351,-35,-27,42,274.13 ,194
20140701,4343,4351,4368,4375,4368,4374,4372,23,21,6,39.35 ,192
20140702,4374,4372,4361,4361,4361,4361,4361,-11,-11,2,13.08 ,192
20140703,4361,4361,4354,4354,4354,4354,4354,-7,-7,2,13.06 ,190
20140704,4354,4354,,,,4372,4372,18,18,0,0.00 ,190
20140707,4372,4372,4324,4324,4319,4321,4321,-51,-51,8,51.86 ,192
20140708,4321,4321,4315,4344,4315,4344,4332,23,11,14,90.99 ,186
20140709,4344,4332,,,,4346,4346,14,14,0,0.00 ,186
20140710,4346,4346,4369,4381,4367,4381,4372,35,26,6,39.35 ,180
20140711,4381,4372,4422,4436,4422,4436,4427,64,55,26,172.67 ,174
20140714,4436,4427,4419,4419,4380,4380,4400,-47,-27,8,52.81 ,174
20140715,4380,4400,4354,4361,4345,4352,4351,-48,-49,16,104.43 ,182
20140716,4352,4351,4360,4370,4324,4329,4339,-22,-12,20,130.19 ,176
20140717,4329,4339,4331,4347,4331,4347,4335,8,-4,8,52.02 ,174
20140718,4347,4335,4341,4371,4341,4371,4356,36,21,4,26.14 ,176
20140721,4371,4356,4343,4354,4343,4354,4348,-2,-8,4,26.09 ,176
20140722,4354,4348,,,,4348,4348,0,0,0,0.00 ,176
20140723,4348,4348,,,,4365,4365,17,17,0,0.00 ,176
20140724,4365,4365,4371,4371,4340,4340,4357,-25,-8,8,52.29 ,178
20140725,4340,4357,4328,4328,4298,4300,4307,-57,-50,40,258.47 ,194
20140728,4300,4307,4306,4306,4306,4306,4306,-1,-1,2,12.92 ,194
20140729,4306,4306,,,,4316,4316,10,10,0,0.00 ,194
20140730,4316,4316,,,,4316,4316,0,0,0,0.00 ,194
20140731,4316,4316,4315,4315,4307,4310,4310,-6,-6,8,51.72 ,194
20140801,4310,4310,,,,4310,4310,0,0,0,0.00 ,194
20140804,4310,4310,4326,4331,4326,4331,4329,21,19,6,38.96 ,194
20140805,4331,4329,4300,4307,4299,4301,4301,-28,-28,20,129.06 ,186
20140806,4301,4301,4274,4274,4237,4237,4244,-64,-57,174,1107.88 ,230
20140807,4237,4244,4257,4263,4247,4247,4257,3,13,154,983.40 ,276
20140808,4247,4257,4266,4266,4266,4266,4266,9,9,12,76.79 ,276
20140811,4266,4266,4231,4238,4231,4231,4231,-35,-35,46,291.97 ,274
20140812,4231,4231,,,,4242,4242,11,11,0,0.00 ,274
20140813,4242,4242,4240,4240,4240,4240,4240,-2,-2,2,12.72 ,274
20140814,4240,4240,4230,4237,4194,4214,4219,-26,-21,116,734.12 ,240
20140815,4214,4219,4210,4210,4210,4210,4210,-9,-9,2,12.63 ,238
20140818,4210,4210,4210,4210,4131,4135,4184,-75,-26,342,2146.67 ,216
20140819,4135,4184,4133,4140,4132,4140,4133,-44,-51,14,86.80 ,214
20140820,4140,4133,4079,4088,4079,4088,4082,-45,-51,8,48.99 ,210
20140821,4088,4082,4128,4128,4097,4097,4120,15,38,8,49.44 ,204
20140822,4097,4120,4107,4115,4107,4115,4112,-5,-8,6,37.01 ,206
20140825,4115,4112,,,,4112,4112,0,0,0,0.00 ,206
20140826,4112,4112,4109,4120,4109,4120,4114,8,2,16,98.75 ,206
20140827,4120,4114,4148,4148,4119,4119,4135,5,21,8,49.63 ,206
20140828,4119,4135,4141,4165,4139,4165,4148,30,13,6,37.34 ,208
20140829,4165,4148,4158,4158,4138,4141,4143,-7,-5,28,174.01 ,232
20140901,4141,4143,4144,4144,4133,4144,4138,1,-5,8,49.66 ,232
20140902,4144,4138,4112,4113,4100,4100,4108,-38,-30,18,110.93 ,238
20140903,4100,4108,4074,4074,4074,4074,4074,-34,-34,2,12.22 ,238
20140904,4074,4074,,,,4074,4074,0,0,0,0.00 ,238
20140905,4074,4074,4070,4070,4057,4064,4062,-10,-12,18,109.68 ,226
20140909,4064,4062,4044,4050,4044,4050,4047,-12,-15,4,24.28 ,222
20140910,4050,4047,4047,4050,4047,4050,4048,3,1,4,24.29 ,222
20140911,4050,4048,4043,4043,4043,4043,4043,-5,-5,2,12.13 ,220
20140912,4043,4043,4010,4010,3991,3991,3992,-52,-51,30,179.65 ,240
20140915,3991,3992,3993,3993,3993,3993,3993,1,1,2,11.98 ,242
20140916,3993,3993,,,,4018,4018,25,25,0,0.00 ,242
20140917,4018,4018,,,,4018,4018,0,0,0,0.00 ,242
20140918,4018,4018,4018,4018,4018,4018,4018,0,0,2,12.05 ,244
20140919,4018,4018,,,,4016,4016,-2,-2,0,0.00 ,244
20140922,4016,4016,3918,3918,3776,3777,3808,-239,-208,42,239.90 ,246
20140923,3777,3808,3725,3804,3725,3804,3764,-4,-44,4,22.59 ,246
20140924,3804,3764,3777,3782,3770,3782,3776,18,12,30,169.93 ,244
20140925,3782,3776,3767,3767,3709,3709,3742,-67,-34,16,89.82 ,234
20140926,3709,3742,3733,3797,3733,3797,3763,55,21,16,90.33 ,228
20140929,3797,3763,3765,3788,3765,3772,3772,9,9,48,271.63 ,228
20140930,3772,3772,3780,3780,3776,3776,3778,4,6,4,22.67 ,226
20141008,3776,3778,3710,3710,3710,3710,3710,-68,-68,2,11.13 ,226
20141009,3710,3710,3741,3741,3741,3741,3741,31,31,2,11.22 ,224
20141010,3741,3741,,,,3781,3781,40,40,0,0.00 ,224
20141013,3781,3781,3814,3814,3796,3796,3805,15,24,20,114.16 ,224
20141014,3796,3805,3800,3800,3798,3798,3799,-7,-6,8,45.59 ,218
20141015,3798,3799,3801,3801,3774,3774,3789,-25,-10,10,56.84 ,214
20141016,3774,3789,3792,3792,3792,3792,3792,3,3,4,22.75 ,214
20141017,3792,3792,,,,3787,3787,-5,-5,0,0.00 ,214
20141020,3787,3787,3768,3768,3768,3768,3768,-19,-19,2,11.30 ,214
20141021,3768,3768,,,,3768,3768,0,0,0,0.00 ,214
20141022,3768,3768,3807,3808,3797,3801,3802,33,34,18,102.68 ,214
20141023,3801,3802,3760,3773,3760,3771,3768,-31,-34,16,90.45 ,214
20141024,3771,3768,,,,3768,3768,0,0,0,0.00 ,214
20141027,3768,3768,3777,3786,3766,3786,3773,18,5,18,101.87 ,214
20141028,3786,3773,,,,3767,3767,-6,-6,0,0.00 ,214
20141029,3767,3767,,,,3774,3774,7,7,0,0.00 ,214
20141030,3774,3774,3776,3776,3690,3691,3752,-83,-22,16,90.06 ,214
20141031,3691,3752,3691,3691,3572,3572,3608,-180,-144,60,324.73 ,186
20141103,3572,3608,3453,3458,3432,3432,3439,-176,-169,68,350.87 ,176
20141104,3432,3439,3419,3430,3418,3430,3420,-9,-19,46,236.04 ,182
20141105,3430,3420,3424,3431,3260,3278,3314,-142,-106,52,258.51 ,168
20141106,3278,3314,3234,3279,3234,3271,3264,-43,-50,44,215.48 ,188
20141107,3271,3264,3265,3265,3182,3225,3223,-39,-41,96,464.13 ,212
20141110,3225,3223,3255,3368,3255,3349,3326,126,103,70,349.23 ,198
20141111,3349,3326,3310,3350,3310,3326,3336,0,10,92,460.48 ,222
20141112,3326,3336,3362,3362,3362,3362,3362,26,26,2,10.09 ,224
20141113,3362,3362,,,,3364,3364,2,2,0,0.00 ,224
20141114,3364,3364,,,,3327,3327,-37,-37,0,0.00 ,224
20141117,3327,3327,3254,3490,3254,3451,3423,124,96,184,945.01 ,218
20141118,3451,3423,3440,3453,3430,3445,3441,22,18,32,165.20 ,212
20141119,3445,3441,3445,3451,3435,3438,3440,-3,-1,94,485.12 ,196
20141120,3438,3440,3448,3475,3398,3422,3419,-18,-21,28,143.62 ,188
20141121,3422,3419,3421,3425,3416,3425,3421,6,2,32,164.22 ,178
20141124,3425,3421,3478,3496,3450,3473,3475,52,54,14,72.98 ,182
20141125,3473,3475,3462,3462,3456,3456,3459,-19,-16,40,207.55 ,180
20141126,3456,3459,3465,3472,3453,3463,3467,4,8,32,166.42 ,176
20141127,3463,3467,3439,3440,3439,3440,3439,-27,-28,16,82.55 ,184
20141128,3440,3439,3428,3438,3382,3382,3398,-57,-41,24,122.36 ,182
20141201,3382,3398,3375,3375,3228,3228,3257,-170,-141,70,341.99 ,226
20141202,3228,3257,3313,3507,3236,3507,3345,250,88,192,963.44 ,184
20141203,3507,3345,3451,3493,3450,3457,3472,112,127,128,666.64 ,168
20141204,3457,3472,3489,3489,3478,3478,3483,6,11,24,125.39 ,174
20141205,3478,3483,3493,3534,3474,3490,3498,7,15,60,314.87 ,162
20141208,3490,3498,3510,3510,3438,3472,3478,-26,-20,60,313.10 ,154
20141209,3472,3478,3473,3511,3461,3511,3470,33,-8,72,374.84 ,176
20141210,3511,3470,3556,3643,3556,3643,3635,173,165,170,927.04 ,276
20141211,3643,3635,3694,3707,3647,3653,3664,18,29,56,307.84 ,268
20141212,3653,3664,3641,3641,3635,3635,3638,-29,-26,4,21.83 ,268
20141215,3635,3638,3688,3688,3600,3600,3652,-38,14,24,131.48 ,258
20141216,3600,3652,3625,3625,3488,3499,3523,-153,-129,32,169.13 ,266
20141217,3499,3523,3477,3477,3477,3477,3477,-46,-46,2,10.43 ,268
20141218,3477,3477,3427,3480,3393,3480,3423,3,-54,86,441.64 ,272
20141219,3480,3423,3489,3507,3478,3478,3486,55,63,10,52.29 ,270
20141222,3478,3486,3495,3495,3490,3490,3493,4,7,8,41.93 ,264
20141223,3490,3493,3456,3456,3420,3423,3435,-70,-58,10,51.53 ,268
20141224,3423,3435,3408,3453,3381,3425,3418,-10,-17,76,389.71 ,264
20141225,3425,3418,3423,3432,3423,3432,3427,14,9,20,102.83 ,260
20141226,3432,3427,3418,3455,3415,3451,3442,24,15,54,278.87 ,276
20141229,3451,3442,3461,3465,3452,3454,3459,12,17,52,269.87 ,256
20141230,3454,3459,3430,3441,3419,3432,3431,-27,-28,22,113.25 ,258
20141231,3432,3431,3539,3539,3496,3503,3527,72,96,18,95.24 ,270
20140516,4156,4156,,,,4113,4113,-43,-43,0,0.00 ,0
20140519,4113,4113,4109,4135,4097,4135,4114,22,1,14,86.39 ,4
20140520,4135,4114,4120,4120,4120,4120,4120,6,6,4,24.72 ,8
20140521,4120,4120,4128,4155,4127,4133,4135,13,15,18,111.65 ,8
20140522,4133,4135,4125,4143,4117,4143,4128,8,-7,6,37.16 ,10
20140523,4143,4128,4122,4146,4122,4146,4134,18,6,4,24.80 ,12
20140526,4146,4134,4143,4143,4143,4143,4143,9,9,2,12.43 ,12
20140527,4143,4143,4146,4146,4107,4107,4131,-36,-12,44,272.70 ,32
20140528,4107,4131,4090,4094,4065,4084,4074,-47,-57,56,342.22 ,68
20140529,4084,4074,4081,4081,4030,4030,4062,-44,-12,76,463.15 ,118
20140530,4030,4062,4048,4060,4048,4059,4055,-3,-7,20,121.67 ,120
20140603,4059,4055,4023,4029,4023,4027,4026,-28,-29,6,36.24 ,118
20140604,4027,4026,4038,4054,4038,4048,4049,22,23,80,485.98 ,188
20140605,4048,4049,4056,4056,4050,4051,4053,2,4,32,194.57 ,186
20140606,4051,4053,4070,4088,4070,4088,4080,35,27,22,134.67 ,190
20140609,4088,4080,4074,4074,4063,4063,4067,-17,-13,12,73.22 ,188
20140610,4063,4067,4068,4069,4065,4069,4067,2,0,6,36.61 ,186
20140611,4069,4067,4088,4088,4088,4088,4088,21,21,2,12.26 ,186
20140612,4088,4088,4072,4072,4067,4067,4068,-21,-20,10,61.02 ,178
20140613,4067,4068,4097,4133,4076,4133,4110,65,42,34,209.65 ,184
20140616,4133,4110,4125,4195,4124,4183,4159,73,49,88,549.09 ,230
20140617,4183,4159,4170,4170,4137,4137,4146,-22,-13,92,572.18 ,206
20140618,4137,4146,4156,4163,4150,4150,4157,4,11,20,124.71 ,204
20140619,4150,4157,4151,4185,4151,4157,4168,0,11,20,125.06 ,210
20140620,4157,4168,4216,4360,4211,4356,4306,188,138,60,387.62 ,208
20140623,4356,4306,4351,4400,4351,4382,4391,76,85,40,263.48 ,228
20140624,4382,4391,4383,4388,4368,4388,4381,-3,-10,8,52.58 ,228
20140625,4388,4381,4388,4388,4349,4352,4382,-29,1,38,249.81 ,224
20140626,4352,4382,4389,4392,4371,4371,4373,-11,-9,46,301.74 ,216
20140627,4371,4373,,,,4373,4373,0,0,0,0.00 ,216
20140630,4373,4373,4353,4353,4341,4341,4349,-32,-24,6,39.14 ,216
20140701,4341,4349,,,,4351,4351,2,2,0,0.00 ,216
20140702,4351,4351,,,,4351,4351,0,0,0,0.00 ,216
20140703,4351,4351,,,,4351,4351,0,0,0,0.00 ,216
20140704,4351,4351,4381,4381,4381,4381,4381,30,30,8,52.57 ,208
20140707,4381,4381,4359,4359,4314,4317,4325,-64,-56,10,64.88 ,206
20140708,4317,4325,4320,4340,4320,4339,4338,14,13,98,637.70 ,284
20140709,4339,4338,4351,4367,4351,4367,4358,29,20,16,104.61 ,282
20140710,4367,4358,4361,4361,4361,4361,4361,3,3,2,13.08 ,280
20140711,4361,4361,4441,4446,4438,4446,4441,85,80,6,39.98 ,276
20140714,4446,4441,4446,4446,4432,4432,4439,-9,-2,16,106.55 ,276
20140715,4432,4439,4371,4371,4369,4369,4370,-70,-69,4,26.22 ,276
20140716,4369,4370,4339,4342,4337,4337,4340,-33,-30,12,78.13 ,274
20140717,4337,4340,4346,4357,4346,4357,4351,17,11,4,26.11 ,272
20140718,4357,4351,4396,4396,4377,4377,4379,26,28,20,131.39 ,280
20140721,4377,4379,4359,4364,4345,4364,4354,-15,-25,14,91.45 ,280
20140722,4364,4354,,,,4354,4354,0,0,0,0.00 ,280
20140723,4354,4354,4388,4390,4376,4380,4383,26,29,10,65.75 ,280
20140724,4380,4383,4388,4388,4350,4352,4365,-31,-18,10,65.48 ,280
20140725,4352,4365,4322,4322,4300,4306,4308,-59,-57,26,168.02 ,280
20140728,4306,4308,4318,4343,4304,4339,4327,31,19,16,103.86 ,280
20140729,4339,4327,4320,4336,4319,4336,4325,9,-2,64,415.23 ,308
20140730,4336,4325,,,,4325,4325,0,0,0,0.00 ,308
20140731,4325,4325,4321,4321,4321,4321,4321,-4,-4,2,12.96 ,308
20140801,4321,4321,,,,4319,4319,-2,-2,0,0.00 ,308
20140804,4319,4319,4329,4340,4327,4327,4334,8,15,8,52.01 ,310
20140805,4327,4334,4323,4323,4294,4311,4309,-23,-25,76,491.29 ,324
20140806,4311,4309,4279,4279,4236,4236,4251,-73,-58,280,1785.70 ,452
20140807,4236,4251,4253,4253,4248,4248,4250,-3,-1,92,586.57 ,388
20140808,4248,4250,4237,4265,4237,4265,4244,15,-6,8,50.94 ,386
20140811,4265,4244,4243,4245,4237,4237,4241,-7,-3,14,89.08 ,376
20140812,4237,4241,4230,4230,4230,4230,4230,-11,-11,2,12.69 ,376
20140813,4230,4230,4248,4248,4248,4248,4248,18,18,2,12.74 ,376
20140814,4248,4248,4213,4217,4213,4215,4214,-33,-34,12,75.85 ,368
20140815,4215,4214,4216,4224,4216,4224,4220,10,6,4,25.32 ,370
20140818,4224,4220,4173,4183,4127,4145,4167,-75,-53,26,162.53 ,370
20140819,4145,4167,4137,4139,4135,4139,4136,-28,-31,8,49.64 ,366
20140820,4139,4136,4094,4094,4094,4094,4094,-42,-42,2,12.28 ,364
20140821,4094,4094,4120,4120,4096,4096,4105,2,11,6,36.95 ,362
20140822,4096,4105,4105,4135,4105,4135,4127,30,22,16,99.07 ,364
20140825,4135,4127,,,,4126,4126,-1,-1,0,0.00 ,364
20140826,4126,4126,,,,4126,4126,0,0,0,0.00 ,364
20140827,4126,4126,4139,4139,4117,4139,4131,13,5,6,37.19 ,366
20140828,4139,4131,4135,4167,4135,4158,4158,27,27,34,212.07 ,394
20140829,4158,4158,4147,4156,4128,4137,4145,-21,-13,356,2213.59 ,532
20140901,4137,4145,4133,4135,4112,4113,4123,-32,-22,48,296.92 ,522
20140902,4113,4123,4111,4111,4111,4111,4111,-12,-12,2,12.33 ,522
20140903,4111,4111,4072,4074,4062,4072,4071,-39,-40,18,109.92 ,532
20140904,4072,4071,4067,4067,4061,4063,4063,-8,-8,14,85.33 ,526
20140905,4063,4063,4080,4080,4050,4055,4059,-8,-4,20,121.78 ,512
20140909,4055,4059,4064,4119,4030,4054,4059,-5,0,12,73.06 ,512
20140910,4054,4059,4022,4063,4022,4044,4046,-15,-13,12,72.84 ,512
20140911,4044,4046,4028,4028,4028,4028,4028,-18,-18,2,12.08 ,514
20140912,4028,4028,4011,4011,3987,4006,3994,-22,-34,40,239.65 ,528
20140915,4006,3994,3991,4003,3991,3996,3996,2,2,6,35.97 ,530
20140916,3996,3996,4012,4027,4012,4025,4022,29,26,8,48.27 ,530
20140917,4025,4022,4030,4030,3994,4021,4009,-1,-13,292,1756.03 ,548
20140918,4021,4009,4015,4015,4003,4003,4011,-6,2,6,36.10 ,546
20140919,4003,4011,4000,4001,4000,4001,4000,-10,-11,40,240.03 ,586
20140922,4001,4000,3914,3916,3760,3760,3781,-240,-219,120,680.70 ,658
20140923,3760,3781,3766,3766,3729,3729,3746,-52,-35,22,123.63 ,660
20140924,3729,3746,3748,3765,3748,3765,3751,19,5,36,202.61 ,654
20140925,3765,3751,3738,3738,3735,3735,3737,-16,-14,6,33.63 ,654
20140926,3735,3737,3709,3787,3708,3775,3725,38,-12,74,413.51 ,648
20140929,3775,3725,3752,3789,3752,3780,3764,55,39,42,237.19 ,636
20140930,3780,3764,3817,3817,3745,3762,3767,-2,3,62,350.37 ,640
20141008,3762,3767,3749,3749,3710,3738,3734,-29,-33,32,179.24 ,648
20141009,3738,3734,3740,3769,3717,3758,3750,24,16,48,270.04 ,654
20141010,3758,3750,3753,3796,3733,3751,3761,1,11,60,338.56 ,630
20141013,3751,3761,3738,3795,3738,3790,3782,29,21,32,181.56 ,632
20141014,3790,3782,3775,3790,3757,3782,3770,0,-12,140,791.82 ,634
20141015,3782,3770,3789,3789,3733,3737,3758,-33,-12,110,620.21 ,636
20141016,3737,3758,3800,3800,3753,3770,3783,12,25,162,919.51 ,754
20141017,3770,3783,3763,3773,3736,3765,3765,-18,-18,122,689.04 ,834
20141020,3765,3765,3764,3772,3721,3772,3760,7,-5,44,248.19 ,850
20141021,3772,3760,3772,3780,3765,3775,3770,15,10,30,169.68 ,842
20141022,3775,3770,3773,3813,3733,3782,3781,12,11,116,657.99 ,848
20141023,3782,3781,3751,3762,3745,3762,3753,-19,-28,40,225.19 ,856
20141024,3762,3753,3757,3757,3747,3748,3750,-5,-3,12,67.51 ,850
20141027,3748,3750,3771,3785,3754,3757,3764,7,14,78,440.50 ,838
20141028,3757,3764,3770,3770,3770,3770,3770,6,6,2,11.31 ,838
20141029,3770,3770,3771,3771,3754,3754,3763,-16,-7,6,33.87 ,840
20141030,3754,3763,3772,3773,3677,3677,3734,-86,-29,80,448.17 ,850
20141031,3677,3734,3601,3648,3547,3555,3592,-179,-142,314,1691.93 ,946
20141103,3555,3592,3453,3475,3412,3439,3441,-153,-151,456,2354.26 ,966
20141104,3439,3441,3444,3448,3409,3422,3425,-19,-16,276,1418.20 ,962
20141105,3422,3425,3420,3430,3274,3274,3344,-151,-81,352,1765.88 ,1048
20141106,3274,3344,3245,3287,3212,3249,3250,-95,-94,528,2574.62 ,998
20141107,3249,3250,3250,3269,3173,3258,3227,8,-23,328,1588.12 ,1024
20141110,3258,3227,3262,3367,3248,3345,3307,118,80,888,4406.03 ,1094
20141111,3345,3307,3303,3339,3303,3315,3319,8,12,486,2419.94 ,1056
20141112,3315,3319,3392,3392,3308,3351,3347,32,28,1182,5935.14 ,1120
20141113,3351,3347,3343,3355,3316,3342,3336,-5,-11,152,760.67 ,1088
20141114,3342,3336,3350,3359,3238,3250,3284,-86,-52,1238,6100.20 ,1102
20141117,3250,3284,3232,3448,3232,3448,3371,164,87,1334,6746.70 ,1146
20141118,3448,3371,3430,3460,3407,3433,3432,62,61,670,3449.58 ,1120
20141119,3433,3432,3440,3453,3416,3438,3434,6,2,940,4842.78 ,1126
20141120,3438,3434,3437,3483,3356,3407,3420,-27,-14,1792,9194.96 ,1654
20141121,3407,3420,3372,3430,3372,3424,3416,4,-4,610,3126.48 ,1692
20141124,3424,3416,3458,3498,3441,3454,3470,38,54,1078,5611.88 ,1668
20141125,3454,3470,3447,3472,3441,3470,3457,0,-13,1060,5498.06 ,1736
20141126,3470,3457,3482,3482,3442,3458,3456,1,-1,918,4759.52 ,1864
20141127,3458,3456,3456,3461,3401,3439,3447,-17,-9,1312,6785.19 ,1828
20141128,3439,3447,3427,3435,3369,3384,3400,-63,-47,710,3621.95 ,1878
20141201,3384,3400,3375,3385,3230,3230,3298,-170,-102,1244,6155.75 ,2008
20141202,3230,3298,3291,3544,3291,3458,3413,160,115,6514,33351.79 ,2206
20141203,3458,3413,3418,3493,3410,3466,3466,53,53,6204,32263.82 ,2204
20141204,3466,3466,3468,3498,3452,3486,3480,20,14,5308,27712.68 ,2382
20141205,3486,3480,3490,3538,3456,3504,3506,24,26,2828,14875.15 ,2474
20141208,3504,3506,3499,3530,3440,3465,3468,-41,-38,5142,26750.17 ,2698
20141209,3465,3468,3467,3505,3446,3503,3473,35,5,1860,9691.62 ,2662
20141210,3503,3473,3541,3646,3540,3646,3605,173,132,6424,34738.99 ,2886
20141211,3646,3605,3638,3721,3625,3639,3667,34,62,8884,48870.79 ,2912
20141212,3639,3667,3650,3823,3630,3656,3653,-11,-14,4230,23181.65 ,2918
20141215,3656,3653,3692,3692,3599,3650,3637,-3,-16,4320,23572.64 ,2880
20141216,3650,3637,3629,3633,3480,3494,3554,-143,-83,4350,23190.52 ,2996
20141217,3494,3554,3566,3579,3399,3446,3470,-108,-84,4272,22239.75 ,3100
20141218,3446,3470,3435,3503,3321,3477,3441,7,-29,5974,30836.30 ,2818
20141219,3477,3441,3477,3515,3456,3483,3483,42,42,3570,18653.97 ,2760
20141222,3483,3483,3525,3525,3465,3498,3489,15,6,2024,10593.33 ,2802
20141223,3498,3489,3490,3492,3402,3420,3453,-69,-36,4266,22101.28 ,2702
20141224,3420,3453,3412,3471,3377,3431,3423,-22,-30,5442,27946.06 ,2712
20141225,3431,3423,3430,3434,3411,3416,3419,-7,-4,3148,16145.38 ,2382
20141226,3416,3419,3421,3462,3415,3450,3438,31,19,1812,9347.11 ,2272
20141229,3450,3438,3497,3497,3450,3465,3467,27,29,4076,21197.43 ,2406
20141230,3465,3467,3454,3485,3427,3451,3450,-16,-17,3048,15777.01 ,2354
20141231,3451,3450,3451,3565,3416,3508,3507,58,57,6112,32156.87 ,2222
20140617,4159,4159,4159,4176,4122,4135,4139,-24,-20,380,2359.46 ,302
20140618,4135,4139,4167,4177,4136,4166,4168,27,29,416,2600.86 ,352
20140619,4166,4168,4172,4225,4163,4198,4180,30,12,168,1053.58 ,388
20140620,4198,4180,4215,4386,4215,4361,4337,181,157,1226,7977.50 ,712
20140623,4361,4337,4370,4431,4364,4391,4393,54,56,1190,7842.76 ,1114
20140624,4391,4393,4402,4402,4372,4396,4385,3,-8,530,3486.77 ,1184
20140625,4396,4385,4399,4424,4344,4370,4380,-15,-5,922,6057.54 ,1310
20140626,4370,4380,4385,4408,4370,4376,4380,-4,0,312,2049.95 ,1308
20140627,4376,4380,4396,4412,4367,4390,4388,10,8,518,3410.24 ,1394
20140630,4390,4388,4391,4404,4347,4368,4365,-20,-23,714,4675.45 ,1550
20140701,4368,4365,4362,4415,4355,4378,4382,13,17,724,4758.92 ,1554
20140702,4378,4382,4381,4402,4372,4388,4380,6,-2,230,1511.19 ,1564
20140703,4388,4380,4384,4403,4360,4368,4382,-12,2,488,3208.17 ,1590
20140704,4368,4382,4351,4403,4351,4400,4383,18,1,274,1801.55 ,1702
20140707,4400,4383,4393,4400,4323,4334,4355,-49,-28,450,2940.05 ,1808
20140708,4334,4355,4336,4362,4325,4360,4348,5,-7,434,2830.58 ,2034
20140709,4360,4348,4360,4380,4345,4370,4363,22,15,578,3783.52 ,2076
20140710,4370,4363,4374,4405,4347,4386,4379,23,16,644,4230.48 ,2266
20140711,4386,4379,4403,4473,4403,4470,4453,91,74,650,4342.63 ,2484
20140714,4470,4453,4465,4467,4402,4404,4444,-49,-9,362,2413.49 ,2474
20140715,4404,4444,4380,4383,4360,4379,4374,-65,-70,494,3241.68 ,2586
20140716,4379,4374,4377,4393,4335,4344,4350,-30,-24,900,5873.39 ,2634
20140717,4344,4350,4348,4373,4342,4366,4357,16,7,422,2758.61 ,2758
20140718,4366,4357,4358,4440,4353,4386,4391,29,34,922,6072.80 ,2834
20140721,4386,4391,4360,4385,4346,4378,4369,-13,-22,974,6383.92 ,3106
20140722,4378,4369,4413,4413,4366,4382,4379,13,10,846,5557.95 ,3244
20140723,4382,4379,4382,4406,4377,4390,4385,11,6,1488,9789.50 ,3390
20140724,4390,4385,4380,4399,4352,4373,4372,-12,-13,854,5600.86 ,3410
20140725,4373,4372,4371,4371,4303,4318,4324,-54,-48,1430,9276.44 ,3958
20140728,4318,4324,4320,4363,4312,4348,4339,24,15,856,5571.40 ,4034
20140729,4348,4339,4333,4348,4333,4339,4341,0,2,406,2643.73 ,4036
20140730,4339,4341,4357,4359,4323,4338,4336,-3,-5,492,3200.11 ,4064
20140731,4338,4336,4339,4358,4322,4351,4337,15,1,986,6414.65 ,4136
20140801,4351,4337,4340,4341,4315,4315,4321,-22,-16,1544,10009.19 ,4596
20140804,4315,4321,4332,4352,4317,4327,4330,6,9,1738,11289.44 ,4878
20140805,4327,4330,4329,4333,4283,4303,4301,-27,-29,980,6323.81 ,4946
20140806,4303,4301,4282,4282,4218,4218,4240,-83,-61,7284,46333.71 ,8234
20140807,4218,4240,4239,4257,4238,4244,4249,4,9,2538,16177.97 ,8616
20140808,4244,4249,4231,4267,4230,4251,4250,2,1,2896,18462.86 ,9870
20140811,4251,4250,4234,4250,4223,4227,4230,-23,-20,4198,26637.57 ,12156
20140812,4227,4230,4240,4245,4232,4242,4236,12,6,3960,25164.20 ,15170
20140813,4242,4236,4249,4250,4223,4239,4234,3,-2,2378,15104.51 ,16270
20140814,4239,4234,4242,4242,4202,4216,4215,-18,-19,2376,15025.61 ,17256
20140815,4216,4215,4216,4227,4208,4218,4215,3,0,1618,10231.11 ,17838
20140818,4218,4215,4168,4185,4118,4137,4141,-78,-74,8274,51394.99 ,21664
20140819,4137,4141,4140,4140,4125,4128,4135,-13,-6,1910,11847.07 ,22284
20140820,4128,4135,4125,4125,4082,4117,4100,-18,-35,5482,33717.21 ,24154
20140821,4117,4100,4116,4137,4089,4096,4111,-4,11,2720,16775.93 ,25142
20140822,4096,4111,4095,4132,4094,4121,4110,10,-1,4578,28229.87 ,26590
20140825,4121,4110,4112,4126,4105,4118,4114,8,4,2160,13332.05 ,27384
20140826,4118,4114,4114,4144,4102,4142,4117,28,3,8946,55257.80 ,33360
20140827,4142,4117,4146,4155,4112,4126,4127,9,10,6752,41807.14 ,36418
20140828,4126,4127,4130,4152,4107,4150,4129,23,2,6618,40992.66 ,39414
20140829,4150,4129,4158,4158,4118,4129,4134,0,5,8918,55304.29 ,43708
20140901,4129,4134,4126,4133,4098,4106,4110,-28,-24,5364,33071.22 ,46558
20140902,4106,4110,4100,4110,4077,4080,4100,-30,-10,7964,48980.88 ,51374
20140903,4080,4100,4061,4075,4056,4069,4064,-31,-36,7318,44616.85 ,54532
20140904,4069,4064,4063,4074,4058,4061,4065,-3,1,4348,26513.72 ,55698
20140905,4061,4065,4066,4090,4035,4043,4055,-22,-10,8148,49571.18 ,58208
20140909,4043,4055,4044,4044,4014,4027,4030,-28,-25,4064,24572.32 ,59680
20140910,4027,4030,4025,4055,4009,4049,4032,19,2,8372,50635.51 ,60812
20140911,4049,4032,4038,4051,4024,4033,4032,1,0,10568,63927.82 ,63854
20140912,4033,4032,4019,4024,3956,3997,3983,-35,-49,27856,166459.64 ,75898
20140915,3997,3983,3985,4001,3970,4001,3985,18,2,12718,76035.75 ,77226
20140916,4001,3985,3998,4033,3987,4007,4009,22,24,12476,75038.98 ,79060
20140917,4007,4009,4013,4030,4004,4021,4016,12,7,19080,114966.28 ,76336
20140918,4021,4016,4015,4038,3981,3987,3997,-29,-19,15288,91660.01 ,79004
20140919,3987,3997,3973,4024,3964,3980,3989,-17,-8,20558,123037.33 ,82394
20140922,3980,3989,3985,3991,3749,3749,3823,-240,-166,65150,373692.67 ,91478
20140923,3749,3823,3760,3769,3703,3727,3738,-96,-85,75658,424315.16 ,100358
20140924,3727,3738,3750,3784,3740,3764,3759,26,21,47064,265384.72 ,109774
20140925,3764,3759,3746,3758,3678,3699,3717,-60,-42,60936,339750.03 ,114902
20140926,3699,3717,3702,3790,3673,3764,3727,47,10,63388,354437.27 ,111904
20140929,3764,3727,3732,3776,3723,3751,3755,24,28,43690,246137.24 ,109268
20140930,3751,3755,3762,3784,3735,3751,3759,-4,4,25732,145092.58 ,112544
20141008,3751,3759,3736,3753,3689,3717,3722,-42,-37,28206,157478.30 ,115052
20141009,3717,3722,3725,3758,3690,3753,3721,31,-1,54814,306001.13 ,115368
20141010,3753,3721,3747,3796,3725,3729,3748,8,27,51722,290783.15 ,123322
20141013,3729,3748,3731,3787,3719,3774,3754,26,6,50180,282611.82 ,121430
20141014,3774,3754,3759,3779,3750,3765,3763,11,9,32626,184181.73 ,125080
20141015,3765,3763,3773,3781,3719,3723,3746,-40,-17,62686,352268.81 ,136284
20141016,3723,3746,3751,3805,3748,3755,3769,9,23,89942,508543.41 ,135454
20141017,3755,3769,3740,3764,3717,3750,3745,-19,-24,76894,431990.05 ,137396
20141020,3750,3745,3748,3764,3736,3764,3748,19,3,49692,279436.71 ,142982
20141021,3764,3748,3769,3776,3751,3766,3763,18,15,54904,309928.30 ,143560
20141022,3766,3763,3786,3792,3765,3776,3780,13,17,56674,321385.52 ,143974
20141023,3776,3780,3750,3762,3726,3752,3745,-28,-35,89584,503264.19 ,147198
20141024,3752,3745,3758,3766,3743,3766,3750,21,5,53036,298401.92 ,149416
20141027,3766,3750,3762,3779,3742,3747,3763,-3,13,68006,383910.03 ,160700
20141028,3747,3763,3749,3771,3741,3753,3754,-10,-9,50976,287092.50 ,167408
20141029,3753,3754,3778,3782,3755,3767,3766,13,12,47146,266379.53 ,172360
20141030,3767,3766,3750,3777,3669,3670,3726,-96,-40,205724,1149837.03 ,218946
20141031,3670,3726,3630,3643,3539,3539,3585,-187,-141,321612,1729746.94 ,286800
20141103,3539,3585,3450,3456,3375,3420,3424,-165,-161,433484,2226567.70 ,298790
20141104,3420,3424,3440,3443,3383,3410,3415,-14,-9,346062,1772797.77 ,364602
20141105,3410,3415,3400,3415,3261,3269,3340,-146,-75,535388,2682416.64 ,453172
20141106,3269,3340,3218,3279,3203,3241,3241,-99,-99,1051414,5112587.02 ,493670
20141107,3241,3241,3225,3258,3155,3240,3217,-1,-24,1395618,6735260.75 ,520886
20141110,3240,3217,3244,3362,3236,3324,3303,107,86,2389448,11840229.50 ,480704
20141111,3324,3303,3301,3332,3290,3305,3312,2,9,1633212,8116088.78 ,481990
20141112,3305,3312,3305,3357,3305,3344,3332,32,20,1184294,5920340.49 ,483880
20141113,3344,3332,3325,3350,3305,3325,3334,-7,2,1258154,6292452.11 ,498082
20141114,3325,3334,3335,3354,3222,3243,3292,-91,-42,1998724,9870255.20 ,583190
20141117,3243,3292,3248,3456,3225,3440,3346,148,54,4392426,22051525.54 ,503792
20141118,3440,3346,3423,3455,3397,3427,3425,81,79,2361452,12133241.41 ,463806
20141119,3427,3425,3435,3446,3406,3429,3428,4,3,1719892,8844499.18 ,464156
20141120,3429,3428,3426,3487,3353,3405,3414,-23,-14,3399466,17408814.93 ,472478
20141121,3405,3414,3417,3432,3395,3429,3415,15,1,1808744,9266846.95 ,467720
20141124,3429,3415,3453,3503,3437,3452,3468,37,53,2460648,12800596.53 ,473366
20141125,3452,3468,3443,3473,3437,3472,3454,4,-14,1145936,5938761.67 ,475330
20141126,3472,3454,3477,3483,3436,3462,3457,8,3,1897038,9839252.57 ,488388
20141127,3462,3457,3454,3462,3392,3436,3434,-21,-23,1647784,8488850.57 ,508550
20141128,3436,3434,3429,3430,3364,3375,3399,-59,-35,1301338,6636601.51 ,539264
20141201,3375,3399,3370,3384,3229,3229,3314,-170,-85,2265360,11261815.22 ,552768
20141202,3229,3314,3285,3548,3283,3455,3411,141,97,5362976,27440429.51 ,454988
20141203,3455,3411,3415,3496,3408,3462,3463,51,52,4649196,24150346.80 ,453642
20141204,3462,3463,3465,3497,3449,3481,3477,18,14,2372274,12375985.74 ,446454
20141205,3481,3477,3477,3538,3450,3501,3505,24,28,3211152,16883631.59 ,452482
20141208,3501,3505,3500,3529,3435,3464,3476,-41,-29,3172562,16544313.23 ,454902
20141209,3464,3476,3466,3505,3442,3502,3465,26,-11,1853536,9634187.37 ,452172
20141210,3502,3465,3536,3638,3534,3638,3599,173,134,3439846,18571579.22 ,486156
20141211,3638,3599,3645,3720,3621,3636,3664,37,65,4166320,22900576.40 ,479582
20141212,3636,3664,3645,3683,3628,3655,3651,-9,-13,2379500,13032889.14 ,495860
20141215,3655,3651,3678,3689,3593,3648,3652,-3,1,2068550,11332347.93 ,484868
20141216,3648,3652,3620,3632,3472,3492,3566,-160,-86,2285282,12224472.53 ,457852
20141217,3492,3566,3568,3577,3389,3442,3463,-124,-103,4471222,23227672.78 ,432610
20141218,3442,3463,3440,3502,3371,3474,3433,11,-30,3447224,17754983.09 ,397960
20141219,3474,3433,3475,3514,3447,3475,3479,42,46,2349256,12260869.88 ,414988
20141222,3475,3479,3466,3496,3458,3493,3479,14,0,1675818,8747076.05 ,439470
20141223,3493,3479,3492,3492,3393,3414,3433,-65,-46,2183162,11244776.96 ,455900
20141224,3414,3433,3397,3474,3366,3429,3414,-4,-19,1978900,10134022.12 ,440064
20141225,3429,3414,3423,3428,3401,3414,3413,0,-1,935536,4789714.65 ,436764
20141226,3414,3413,3416,3464,3413,3450,3441,37,28,680196,3511000.08 ,423450
20141229,3450,3441,3491,3497,3449,3475,3468,34,27,1280768,6662688.21 ,405588
20141230,3475,3468,3462,3492,3428,3456,3452,-12,-16,1554396,8050057.48 ,411038
20141231,3456,3452,3451,3580,3447,3522,3524,70,72,2393764,12653955.52 ,392680
20140716,4374,4374,,,,4372,4372,-2,-2,0,0.00 ,0
20140717,4372,4372,,,,4372,4372,0,0,0,0.00 ,0
20140718,4372,4372,,,,4372,4372,0,0,0,0.00 ,0
20140721,4372,4372,,,,4350,4350,-22,-22,0,0.00 ,0
20140722,4350,4350,,,,4376,4376,26,26,0,0.00 ,0
20140723,4376,4376,,,,4376,4376,0,0,0,0.00 ,0
20140724,4376,4376,,,,4376,4376,0,0,0,0.00 ,0
20140725,4376,4376,,,,4376,4376,0,0,0,0.00 ,0
20140728,4376,4376,,,,4364,4364,-12,-12,0,0.00 ,0
20140729,4364,4364,,,,4364,4364,0,0,0,0.00 ,0
20140730,4364,4364,,,,4364,4364,0,0,0,0.00 ,0
20140731,4364,4364,,,,4364,4364,0,0,0,0.00 ,0
20140801,4364,4364,,,,4334,4334,-30,-30,0,0.00 ,0
20140804,4334,4334,4332,4332,4332,4332,4332,-2,-2,2,13.00 ,2
20140805,4332,4332,4297,4314,4297,4314,4305,-18,-27,4,25.83 ,4
20140806,4314,4305,4248,4248,4236,4236,4237,-69,-68,24,152.56 ,26
20140807,4236,4237,4255,4258,4252,4255,4255,18,18,8,51.06 ,24
20140808,4255,4255,4240,4240,4240,4240,4240,-15,-15,2,12.72 ,22
20140811,4240,4240,4242,4242,4237,4237,4239,-3,-1,6,38.15 ,26
20140812,4237,4239,,,,4245,4245,6,6,0,0.00 ,26
20140813,4245,4245,4247,4247,4225,4239,4232,-6,-13,16,101.59 ,24
20140814,4239,4232,4235,4235,4204,4220,4216,-12,-16,14,88.54 ,24
20140815,4220,4216,,,,4216,4216,0,0,0,0.00 ,24
20140818,4216,4216,,,,4179,4179,-37,-37,0,0.00 ,24
20140819,4179,4179,,,,4179,4179,0,0,0,0.00 ,24
20140820,4179,4179,4111,4111,4080,4089,4092,-90,-87,118,724.34 ,26
20140821,4089,4092,4116,4116,4093,4093,4098,1,6,8,49.19 ,32
20140822,4093,4098,4108,4127,4108,4125,4116,27,18,12,74.10 ,30
20140825,4125,4116,4107,4107,4107,4107,4107,-9,-9,2,12.32 ,32
20140826,4107,4107,,,,4136,4136,29,29,0,0.00 ,32
20140827,4136,4136,,,,4146,4146,10,10,0,0.00 ,32
20140828,4146,4146,4125,4137,4125,4137,4131,-9,-15,4,24.79 ,32
20140829,4137,4131,4148,4157,4127,4135,4134,4,3,52,322.52 ,46
20140901,4135,4134,4132,4132,4117,4117,4123,-17,-11,6,37.11 ,46
20140902,4117,4123,4116,4116,4107,4107,4112,-16,-11,10,61.69 ,50
20140903,4107,4112,4078,4078,4078,4078,4078,-34,-34,2,12.23 ,50
20140904,4078,4078,,,,4072,4072,-6,-6,0,0.00 ,50
20140905,4072,4072,4064,4064,4047,4047,4052,-25,-20,20,121.58 ,64
20140909,4047,4052,4044,4046,4044,4046,4045,-6,-7,4,24.27 ,62
20140910,4046,4045,4078,4078,4045,4045,4057,0,12,6,36.52 ,62
20140911,4045,4057,4040,4047,4040,4047,4041,-10,-16,8,48.50 ,56
20140912,4047,4041,3970,3970,3957,3957,3963,-84,-78,4,23.78 ,56
20140915,3957,3963,,,,3963,3963,0,0,0,0.00 ,56
20140916,3963,3963,,,,3987,3987,24,24,0,0.00 ,56
20140917,3987,3987,4012,4012,4012,4012,4012,25,25,2,12.04 ,54
20140918,4012,4012,4009,4009,3990,3990,3999,-22,-13,4,24.00 ,56
20140919,3990,3999,3999,3999,3989,3989,3994,-10,-5,4,23.96 ,58
20140922,3989,3994,3770,3770,3767,3767,3767,-227,-227,14,79.12 ,70
20140923,3767,3767,3736,3736,3704,3726,3719,-41,-48,18,100.43 ,64
20140924,3726,3719,3746,3758,3743,3743,3750,24,31,8,45.00 ,64
20140925,3743,3750,3725,3743,3686,3686,3723,-64,-27,38,212.25 ,64
20140926,3686,3723,3706,3767,3673,3767,3733,44,10,24,134.39 ,62
20140929,3767,3733,3733,3775,3733,3741,3756,8,23,24,135.23 ,62
20140930,3741,3756,3751,3798,3751,3770,3774,14,18,48,271.79 ,74
20141008,3770,3774,,,,3730,3730,-44,-44,0,0.00 ,74
20141009,3730,3730,3735,3763,3731,3763,3743,33,13,8,44.93 ,78
20141010,3763,3743,3763,3763,3747,3747,3754,4,11,6,33.79 ,78
20141013,3747,3754,3776,3777,3776,3777,3776,23,22,18,101.96 ,90
20141014,3777,3776,3755,3778,3755,3778,3777,2,1,436,2470.44 ,496
20141015,3778,3777,3781,3781,3735,3747,3747,-30,-30,176,989.46 ,650
20141016,3747,3747,3763,3801,3763,3769,3777,22,30,38,215.32 ,644
20141017,3769,3777,3746,3775,3735,3760,3761,-17,-16,140,789.89 ,758
20141020,3760,3761,3767,3773,3753,3773,3762,12,1,70,395.05 ,756
20141021,3773,3762,3767,3782,3760,3782,3765,20,3,30,169.44 ,764
20141022,3782,3765,3795,3795,3782,3782,3789,17,24,28,159.14 ,752
20141023,3782,3789,3746,3755,3745,3746,3746,-43,-43,22,123.65 ,760
20141024,3746,3746,3755,3761,3754,3754,3757,8,11,20,112.72 ,756
20141027,3754,3757,3780,3780,3755,3755,3767,-2,10,4,22.61 ,754
20141028,3755,3767,3753,3760,3752,3760,3754,-7,-13,16,90.10 ,742
20141029,3760,3754,,,,3771,3771,17,17,0,0.00 ,742
20141030,3771,3771,3748,3748,3690,3690,3706,-81,-65,46,255.76 ,770
20141031,3690,3706,3646,3646,3520,3520,3562,-186,-144,178,951.26 ,756
20141103,3520,3562,3431,3440,3383,3422,3413,-140,-149,1656,8478.65 ,680
20141104,3422,3413,3422,3438,3401,3411,3422,-2,9,172,882.89 ,656
20141105,3411,3422,3408,3408,3271,3271,3342,-151,-80,80,401.07 ,704
20141106,3271,3342,3259,3273,3222,3248,3244,-94,-98,56,272.55 ,706
20141107,3248,3244,3241,3246,3163,3225,3186,-19,-58,140,669.17 ,634
20141110,3225,3186,3240,3345,3240,3329,3319,143,133,764,3804.70 ,620
20141111,3329,3319,3320,3329,3297,3305,3319,-14,0,240,1195.09 ,636
20141112,3305,3319,3314,3356,3314,3345,3342,26,23,44,220.59 ,618
20141113,3345,3342,3340,3350,3317,3335,3340,-7,-2,88,441.01 ,604
20141114,3335,3340,3342,3346,3232,3242,3296,-98,-44,58,286.79 ,616
20141117,3242,3296,3232,3460,3232,3443,3404,147,108,168,857.90 ,560
20141118,3443,3404,3431,3449,3420,3429,3428,25,24,76,390.82 ,536
20141119,3429,3428,3437,3447,3423,3430,3432,2,4,30,154.45 ,538
20141120,3430,3432,3435,3486,3367,3413,3429,-19,-3,152,781.88 ,534
20141121,3413,3429,3425,3432,3410,3430,3423,1,-6,24,123.24 ,532
20141124,3430,3423,3480,3480,3452,3464,3462,41,39,34,176.58 ,530
20141125,3464,3462,3456,3467,3454,3467,3462,5,0,154,799.85 ,606
20141126,3467,3462,3475,3476,3457,3460,3467,-2,5,28,145.65 ,606
20141127,3460,3467,3458,3463,3400,3421,3449,-46,-18,98,507.10 ,634
20141128,3421,3449,3417,3417,3371,3378,3396,-71,-53,44,224.20 ,638
20141201,3378,3396,3380,3384,3226,3226,3316,-170,-80,94,467.65 ,640
20141202,3226,3316,3324,3540,3318,3476,3463,160,147,520,2701.51 ,802
20141203,3476,3463,3435,3483,3435,3455,3463,-8,0,218,1132.55 ,806
20141204,3455,3463,3477,3493,3469,3469,3479,6,16,128,668.02 ,836
20141205,3469,3479,3486,3650,3431,3491,3524,12,45,940,4970.19 ,944
20141208,3491,3524,3508,3528,3459,3466,3488,-58,-36,98,512.80 ,936
20141209,3466,3488,3461,3497,3448,3497,3472,9,-16,520,2708.57 ,948
20141210,3497,3472,3573,3641,3558,3630,3587,158,115,100,538.19 ,924
20141211,3630,3587,3680,3715,3629,3635,3665,48,78,494,2716.17 ,1032
20141212,3635,3665,3652,3675,3635,3654,3650,-11,-15,124,678.97 ,994
20141215,3654,3650,3685,3685,3609,3647,3661,-3,11,150,823.85 ,1000
20141216,3647,3661,3622,3626,3487,3502,3530,-159,-131,86,455.45 ,1004
20141217,3502,3530,3552,3552,3405,3434,3465,-96,-65,62,322.28 ,990
20141218,3434,3465,3427,3500,3408,3475,3429,10,-36,870,4475.38 ,1032
20141219,3475,3429,3473,3505,3473,3475,3487,46,58,132,690.52 ,1012
20141222,3475,3487,3465,3491,3463,3483,3473,-4,-14,40,208.42 ,1010
20141223,3483,3473,3465,3465,3400,3419,3445,-54,-28,26,134.36 ,1000
20141224,3419,3445,3402,3470,3382,3431,3431,-14,-14,78,401.45 ,1024
20141225,3431,3431,3422,3428,3417,3419,3421,-12,-10,12,61.58 ,1024
20141226,3419,3421,3443,3450,3440,3450,3446,29,25,10,51.70 ,1022
20141229,3450,3446,3487,3487,3462,3479,3475,33,29,20,104.28 ,1022
20141230,3479,3475,3476,3491,3433,3459,3450,-16,-25,64,331.23 ,998
20141231,3459,3450,3478,3566,3478,3501,3528,51,78,64,338.73 ,974
20140818,4216,4216,,,,4164,4164,-52,-52,0,0.00 ,0
20140819,4164,4164,4164,4200,4126,4140,4163,-24,-1,120,749.43 ,10
20140820,4140,4163,4061,4112,4060,4112,4077,-51,-86,244,1492.50 ,22
20140821,4112,4077,4130,4130,4103,4103,4118,26,41,6,37.07 ,18
20140822,4103,4118,4125,4125,4125,4125,4125,7,7,2,12.38 ,16
20140825,4125,4125,4127,4129,4127,4129,4128,4,3,4,24.77 ,12
20140826,4129,4128,,,,4131,4131,3,3,0,0.00 ,12
20140827,4131,4131,,,,4141,4141,10,10,0,0.00 ,12
20140828,4141,4141,,,,4126,4126,-15,-15,0,0.00 ,12
20140829,4126,4126,4131,4131,4096,4096,4118,-30,-8,6,37.07 ,12
20140901,4096,4118,4120,4120,4107,4110,4108,-8,-10,24,147.90 ,34
20140902,4110,4108,4111,4124,4083,4083,4097,-25,-11,20,122.93 ,34
20140903,4083,4097,4065,4073,4065,4072,4067,-25,-30,16,97.62 ,36
20140904,4072,4067,4061,4077,4061,4077,4073,10,6,10,61.11 ,42
20140905,4077,4073,4088,4088,4062,4065,4069,-8,-4,12,73.26 ,40
20140909,4065,4069,,,,4044,4044,-25,-25,0,0.00 ,40
20140910,4044,4044,4022,4059,4022,4053,4039,9,-5,16,96.94 ,38
20140911,4053,4039,4054,4054,4033,4033,4037,-6,-2,18,109.02 ,48
20140912,4033,4037,3976,3979,3965,3965,3970,-72,-67,10,59.56 ,50
20140915,3965,3970,3995,4007,3995,4007,4001,37,31,4,24.01 ,50
20140916,4007,4001,3996,3996,3996,3996,3996,-5,-5,2,11.99 ,50
20140917,3996,3996,,,,4012,4012,16,16,0,0.00 ,50
20140918,4012,4012,4023,4026,3994,3994,4020,-18,8,12,72.36 ,52
20140919,3994,4020,,,,4018,4018,-2,-2,0,0.00 ,52
20140922,4018,4018,3942,3942,3776,3776,3833,-242,-185,38,218.53 ,78
20140923,3776,3833,3750,3768,3732,3768,3754,-65,-79,28,157.69 ,90
20140924,3768,3754,,,,3785,3785,31,31,0,0.00 ,90
20140925,3785,3785,3743,3743,3702,3706,3717,-79,-68,14,78.08 ,96
20140926,3706,3717,3673,3771,3673,3751,3724,34,7,22,122.91 ,104
20140929,3751,3724,3768,3791,3743,3762,3771,38,47,76,429.91 ,124
20140930,3762,3771,3779,3790,3723,3773,3777,2,6,42,238.01 ,110
20141008,3773,3777,3773,3773,3726,3742,3743,-35,-34,58,325.71 ,162
20141009,3742,3743,3737,3773,3716,3773,3739,30,-4,22,123.41 ,174
20141010,3773,3739,3766,3789,3758,3758,3771,19,32,126,712.73 ,230
20141013,3758,3771,3780,3783,3769,3773,3774,2,3,90,509.58 ,180
20141014,3773,3774,3747,3771,3747,3770,3767,-4,-7,42,237.35 ,168
20141015,3770,3767,3766,3780,3725,3780,3757,13,-10,14,78.90 ,170
20141016,3780,3757,3798,3809,3765,3765,3774,8,17,48,271.77 ,152
20141017,3765,3774,3763,3763,3753,3756,3757,-18,-17,30,169.10 ,138
20141020,3756,3757,3762,3763,3762,3763,3762,6,5,4,22.58 ,140
20141021,3763,3762,3780,3780,3772,3772,3776,10,14,4,22.66 ,140
20141022,3772,3776,3781,3781,3768,3772,3776,-4,0,30,169.92 ,132
20141023,3772,3776,,,,3768,3768,-8,-8,0,0.00 ,132
20141024,3768,3768,3772,3772,3772,3772,3772,4,4,6,33.95 ,138
20141027,3772,3772,3770,3776,3770,3776,3774,4,2,32,181.19 ,134
20141028,3776,3774,3749,3768,3749,3768,3759,-6,-15,10,56.39 ,130
20141029,3768,3759,,,,3770,3770,11,11,0,0.00 ,130
20141030,3770,3770,3772,3772,3713,3713,3745,-57,-25,10,56.18 ,132
20141031,3713,3745,3637,3637,3560,3560,3593,-185,-152,12,64.67 ,140
20141103,3560,3593,3456,3456,3413,3430,3441,-163,-152,24,123.89 ,142
20141104,3430,3441,,,,3441,3441,0,0,0,0.00 ,142
20141105,3441,3441,3433,3433,3299,3299,3367,-142,-74,24,121.24 ,154
20141106,3299,3367,3249,3277,3235,3270,3261,-97,-106,38,185.93 ,164
20141107,3270,3261,3250,3258,3180,3253,3234,-8,-27,28,135.85 ,170
20141110,3253,3234,3268,3369,3248,3347,3301,113,67,48,237.72 ,162
20141111,3347,3301,3336,3336,3220,3313,3286,12,-15,12,59.15 ,166
20141112,3313,3286,3324,3360,3324,3350,3346,64,60,22,110.42 ,166
20141113,3350,3346,3341,3346,3341,3346,3342,0,-4,6,30.08 ,160
20141114,3346,3342,3348,3352,3231,3250,3311,-92,-31,64,317.95 ,156
20141117,3250,3311,3256,3476,3256,3439,3422,128,111,70,359.31 ,152
20141118,3439,3422,3427,3427,3422,3427,3425,5,3,8,41.10 ,152
20141119,3427,3425,3423,3432,3423,3432,3428,7,3,14,71.99 ,154
20141120,3432,3428,3417,3474,3392,3392,3429,-36,1,22,113.18 ,148
20141121,3392,3429,3402,3430,3402,3426,3425,-3,-4,62,318.54 ,168
20141124,3426,3425,3485,3485,3460,3460,3463,35,38,18,93.52 ,180
20141125,3460,3463,3460,3470,3459,3468,3467,5,4,64,332.84 ,200
20141126,3468,3467,3467,3467,3445,3461,3454,-6,-13,26,134.74 ,200
20141127,3461,3454,3455,3465,3415,3415,3457,-39,3,54,280.02 ,212
20141128,3415,3457,3431,3431,3394,3394,3418,-63,-39,6,30.77 ,212
20141201,3394,3418,3350,3350,3247,3247,3294,-171,-124,8,39.53 ,212
20141202,3247,3294,3318,3535,3318,3481,3460,187,166,160,830.42 ,292
20141203,3481,3460,3456,3483,3455,3464,3464,4,4,14,72.75 ,288
20141204,3464,3464,3480,3483,3467,3480,3479,16,15,70,365.38 ,310
20141205,3480,3479,3490,3520,3460,3494,3492,15,13,42,220.03 ,318
20141208,3494,3492,3503,3503,3444,3463,3475,-29,-17,106,552.61 ,294
20141209,3463,3475,3469,3491,3465,3491,3472,16,-3,26,135.42 ,298
20141210,3491,3472,3580,3645,3580,3645,3631,173,159,54,294.18 ,276
20141211,3645,3631,3715,3715,3634,3640,3655,9,24,34,186.42 ,276
20141212,3640,3655,3646,3670,3646,3658,3664,3,9,22,120.91 ,282
20141215,3658,3664,3632,3632,3608,3630,3617,-34,-47,38,206.18 ,266
20141216,3630,3617,3620,3620,3507,3516,3546,-101,-71,34,180.89 ,276
20141217,3516,3546,3672,3672,3434,3442,3571,-104,25,68,364.34 ,276
20141218,3442,3571,3410,3490,3396,3485,3433,-86,-138,162,834.30 ,266
20141219,3485,3433,3462,3503,3462,3482,3480,49,47,40,208.84 ,256
20141222,3482,3480,3492,3497,3481,3497,3486,17,6,64,334.71 ,268
20141223,3497,3486,3490,3490,3414,3415,3441,-71,-45,72,371.67 ,270
20141224,3415,3441,3415,3459,3378,3436,3422,-5,-19,84,431.27 ,272
20141225,3436,3422,3411,3416,3411,3416,3413,-6,-9,4,20.48 ,272
20141226,3416,3413,3418,3460,3418,3460,3446,47,33,50,258.46 ,264
20141229,3460,3446,3483,3483,3460,3478,3473,32,27,24,125.03 ,262
20141230,3478,3473,3489,3491,3452,3453,3470,-20,-3,32,166.60 ,272
20141231,3453,3470,3469,3576,3469,3508,3532,38,62,96,508.63 ,262
20140916,4001,4001,4034,4034,3994,3994,4014,-7,13,4,24.08 ,2
20140917,3994,4014,,,,4014,4014,0,0,0,0.00 ,2
20140918,4014,4014,3993,4000,3993,4000,3995,-14,-19,6,35.96 ,6
20140919,4000,3995,3985,3985,3985,3985,3985,-10,-10,2,11.96 ,8
20140922,3985,3985,3975,3975,3747,3755,3785,-230,-200,42,238.46 ,38
20140923,3755,3785,3758,3758,3758,3758,3758,-27,-27,4,22.55 ,38
20140924,3758,3758,3788,3788,3788,3788,3788,30,30,2,11.36 ,40
20140925,3788,3788,3727,3747,3706,3718,3731,-70,-57,16,89.56 ,48
20140926,3718,3731,3721,3790,3721,3790,3759,59,28,18,101.51 ,46
20140929,3790,3759,3768,3768,3768,3768,3768,9,9,2,11.30 ,48
20140930,3768,3768,,,,3768,3768,0,0,0,0.00 ,48
20141008,3768,3768,3765,3787,3686,3758,3732,-10,-36,106,593.50 ,88
20141009,3758,3732,3733,3783,3733,3768,3754,36,22,8,45.06 ,84
20141010,3768,3754,3788,3788,3750,3750,3770,-4,16,14,79.17 ,80
20141013,3750,3770,3791,3792,3769,3778,3780,8,10,38,215.50 ,80
20141014,3778,3780,,,,3780,3780,0,0,0,0.00 ,80
20141015,3780,3780,3741,3762,3741,3748,3753,-32,-27,14,78.82 ,86
20141016,3748,3753,3810,3810,3784,3784,3796,31,43,10,56.94 ,84
20141017,3784,3796,3717,3740,3717,3740,3728,-56,-68,4,22.37 ,86
20141020,3740,3728,3760,3761,3758,3758,3759,30,31,8,45.11 ,90
20141021,3758,3759,3776,3776,3776,3776,3776,17,17,2,11.33 ,90
20141022,3776,3776,3791,3791,3791,3791,3791,15,15,2,11.37 ,88
20141023,3791,3791,3748,3771,3737,3771,3756,-20,-35,14,78.89 ,98
20141024,3771,3756,3767,3767,3767,3767,3767,11,11,2,11.30 ,98
20141027,3767,3767,3800,3800,3765,3790,3787,23,20,108,613.57 ,148
20141028,3790,3787,3779,3799,3777,3780,3782,-7,-5,32,181.54 ,140
20141029,3780,3782,3782,3782,3782,3782,3782,0,0,2,11.35 ,142
20141030,3782,3782,3786,3798,3719,3719,3750,-63,-32,36,202.52 ,152
20141031,3719,3750,3670,3670,3562,3568,3597,-182,-153,80,431.69 ,206
20141103,3568,3597,3502,3502,3430,3455,3461,-142,-136,186,965.73 ,208
20141104,3455,3461,3455,3458,3424,3442,3447,-19,-14,56,289.57 ,216
20141105,3442,3447,3429,3433,3292,3307,3348,-140,-99,50,251.17 ,234
20141106,3307,3348,3260,3305,3249,3287,3270,-61,-78,68,333.63 ,236
20141107,3287,3270,3265,3271,3199,3270,3252,0,-18,150,731.91 ,324
20141110,3270,3252,3274,3408,3274,3360,3324,108,72,66,329.14 ,316
20141111,3360,3324,3317,3338,3317,3335,3330,11,6,10,49.96 ,316
20141112,3335,3330,3337,3362,3337,3362,3349,32,19,6,30.15 ,314
20141113,3362,3349,3352,3360,3331,3356,3345,7,-4,12,60.22 ,312
20141114,3356,3345,3355,3355,3253,3253,3279,-92,-66,14,68.87 ,312
20141117,3253,3279,3338,3442,3338,3442,3425,163,146,214,1099.64 ,298
20141118,3442,3425,3441,3441,3418,3426,3431,1,6,24,123.53 ,288
20141119,3426,3431,3451,3452,3436,3439,3449,8,18,62,320.78 ,248
20141120,3439,3449,3440,3456,3386,3422,3414,-27,-35,38,194.63 ,250
20141121,3422,3414,3423,3433,3421,3423,3424,9,10,28,143.84 ,248
20141124,3423,3424,3455,3480,3448,3460,3468,36,44,34,176.89 ,238
20141125,3460,3468,3460,3470,3460,3469,3462,1,-6,22,114.27 ,232
20141126,3469,3462,3473,3475,3425,3465,3468,3,6,78,405.80 ,260
20141127,3465,3468,3465,3475,3418,3433,3457,-35,-11,52,269.70 ,266
20141128,3433,3457,3435,3435,3389,3389,3414,-68,-43,18,92.19 ,270
20141201,3389,3414,3375,3375,3243,3243,3315,-171,-99,188,934.96 ,358
20141202,3243,3315,3335,3540,3335,3480,3429,165,114,370,1903.55 ,410
20141203,3480,3429,3491,3494,3448,3458,3476,29,47,22,114.71 ,410
20141204,3458,3476,3482,3492,3461,3480,3483,4,7,418,2184.44 ,636
20141205,3480,3483,3489,3528,3470,3506,3514,23,31,450,2372.08 ,854
20141208,3506,3514,3525,3527,3455,3458,3489,-56,-25,132,690.90 ,826
20141209,3458,3489,3480,3512,3459,3512,3487,23,-2,50,261.57 ,834
20141210,3512,3487,3576,3661,3571,3661,3606,174,119,130,703.32 ,854
20141211,3661,3606,3668,3720,3642,3659,3667,53,61,78,429.11 ,858
20141212,3659,3667,3660,3692,3656,3665,3669,-2,2,178,979.73 ,904
20141215,3665,3669,3687,3687,3627,3655,3662,-14,-7,96,527.43 ,864
20141216,3655,3662,3631,3634,3493,3517,3530,-145,-132,124,656.75 ,856
20141217,3517,3530,3566,3566,3433,3450,3480,-80,-50,118,616.03 ,868
20141218,3450,3480,3407,3496,3396,3496,3465,16,-15,50,259.88 ,862
20141219,3496,3465,3491,3525,3477,3477,3506,12,41,48,252.44 ,864
20141222,3477,3506,3509,3509,3496,3504,3504,-2,-2,10,52.57 ,868
20141223,3504,3504,3456,3456,3427,3427,3441,-77,-63,12,61.95 ,870
20141224,3427,3441,3405,3471,3389,3443,3427,2,-14,30,154.22 ,866
20141225,3443,3427,3424,3438,3424,3438,3429,11,2,8,41.15 ,866
20141226,3438,3429,3436,3468,3436,3468,3455,39,26,46,238.40 ,868
20141229,3468,3455,,,,3487,3487,32,32,0,0.00 ,868
20141230,3487,3487,3501,3501,3459,3482,3480,-5,-7,6,31.33 ,866
20141231,3482,3480,3476,3563,3476,3518,3510,38,30,24,126.37 ,874
20141016,3753,3753,,,,3753,3753,0,0,0,0.00 ,0
20141017,3753,3753,3753,3753,3753,3753,3753,0,0,2,11.26 ,2
20141020,3753,3753,,,,3784,3784,31,31,0,0.00 ,2
20141021,3784,3784,,,,3784,3784,0,0,0,0.00 ,2
20141022,3784,3784,3803,3803,3801,3801,3802,17,18,4,22.81 ,4
20141023,3801,3802,3767,3782,3767,3782,3774,-20,-28,4,22.65 ,6
20141024,3782,3774,3762,3762,3762,3762,3762,-12,-12,2,11.29 ,6
20141027,3762,3762,,,,3762,3762,0,0,0,0.00 ,6
20141028,3762,3762,,,,3782,3782,20,20,0,0.00 ,6
20141029,3782,3782,,,,3783,3783,1,1,0,0.00 ,6
20141030,3783,3783,3754,3815,3724,3733,3789,-50,6,278,1580.26 ,140
20141031,3733,3789,3685,3693,3599,3599,3622,-190,-167,172,934.51 ,270
20141103,3599,3622,3490,3506,3450,3461,3461,-161,-161,458,2378.08 ,486
20141104,3461,3461,3468,3475,3433,3446,3459,-15,-2,34,176.43 ,494
20141105,3446,3459,3427,3446,3321,3321,3391,-138,-68,92,468.03 ,520
20141106,3321,3391,3300,3300,3249,3271,3274,-120,-117,86,422.46 ,542
20141107,3271,3274,3272,3272,3199,3246,3247,-28,-27,280,1363.85 ,762
20141110,3246,3247,3284,3382,3284,3365,3329,118,82,150,749.18 ,760
20141111,3365,3329,3348,3351,3319,3319,3339,-10,10,458,2294.17 ,810
20141112,3319,3339,3337,3374,3335,3374,3351,35,12,8,40.21 ,810
20141113,3374,3351,3364,3368,3323,3360,3350,9,-1,22,110.58 ,814
20141114,3360,3350,3359,3378,3243,3252,3299,-98,-51,32,158.38 ,818
20141117,3252,3299,3250,3463,3250,3454,3426,155,127,100,514.02 ,800
20141118,3454,3426,3434,3452,3410,3439,3437,13,11,104,536.23 ,824
20141119,3439,3437,3445,3459,3430,3431,3448,-6,11,54,279.31 ,814
20141120,3431,3448,3451,3465,3366,3431,3409,-17,-39,44,225.06 ,812
20141121,3431,3409,3422,3440,3422,3438,3432,29,23,26,133.86 ,810
20141124,3438,3432,3476,3516,3462,3470,3474,38,42,154,802.72 ,846
20141125,3470,3474,3464,3473,3457,3471,3467,-3,-7,68,353.66 ,876
20141126,3471,3467,3497,3497,3453,3473,3475,6,8,962,5014.44 ,1484
20141127,3473,3475,3473,3480,3418,3452,3453,-23,-22,68,352.25 ,1496
20141128,3452,3453,3444,3447,3388,3398,3418,-55,-35,62,317.89 ,1508
20141201,3398,3418,3383,3383,3247,3247,3311,-171,-107,38,188.73 ,1514
20141202,3247,3311,3321,3551,3321,3466,3471,155,160,498,2593.22 ,1556
20141203,3466,3471,3430,3500,3430,3467,3471,-4,0,130,676.91 ,1608
20141204,3467,3471,3481,3505,3460,3489,3487,18,16,396,2071.62 ,1732
20141205,3489,3487,3532,3532,3475,3508,3516,21,29,472,2489.51 ,2038
20141208,3508,3516,3510,3510,3456,3473,3477,-43,-39,50,260.85 ,2034
20141209,3473,3477,3471,3506,3469,3506,3480,29,3,20,104.43 ,2040
20141210,3506,3480,3553,3654,3553,3654,3636,174,156,1156,6305.90 ,1992
20141211,3654,3636,3690,3724,3636,3648,3674,12,38,126,694.56 ,1966
20141212,3648,3674,3658,3690,3647,3657,3669,-17,-5,278,1529.99 ,2074
20141215,3657,3669,3690,3694,3618,3662,3669,-7,0,118,649.43 ,2068
20141216,3662,3669,3647,3647,3489,3516,3545,-153,-124,126,670.04 ,2036
20141217,3516,3545,3609,3609,3453,3457,3525,-88,-20,138,729.77 ,2056
20141218,3457,3525,3457,3519,3433,3499,3468,-26,-57,48,249.77 ,2054
20141219,3499,3468,3501,3534,3485,3494,3503,26,35,34,178.66 ,2060
20141222,3494,3503,3513,3513,3509,3509,3511,6,8,4,21.07 ,2060
20141223,3509,3511,3490,3490,3420,3420,3432,-91,-79,138,710.43 ,2026
20141224,3420,3432,3395,3469,3395,3449,3442,17,10,56,289.16 ,2024
20141225,3449,3442,3435,3438,3435,3438,3436,-4,-6,4,20.62 ,2022
20141226,3438,3436,3462,3478,3461,3476,3470,40,34,12,62.47 ,2024
20141229,3476,3470,3528,3528,3488,3499,3500,29,30,10,52.51 ,2030
20141230,3499,3500,3494,3500,3456,3476,3470,-24,-30,72,374.85 ,2028
20141231,3476,3470,3494,3595,3494,3523,3547,53,77,76,404.46 ,2008
20141118,3426,3426,,,,3426,3426,0,0,0,0.00 ,0
20141119,3426,3426,,,,3426,3426,0,0,0,0.00 ,0
20141120,3426,3426,3421,3447,3421,3425,3434,-1,8,34,175.18 ,22
20141121,3425,3434,3440,3447,3440,3440,3442,6,8,10,51.64 ,22
20141124,3440,3442,3475,3477,3450,3450,3462,8,20,20,103.88 ,18
20141125,3450,3462,3468,3492,3446,3472,3467,10,5,18,93.63 ,22
20141126,3472,3467,3463,3472,3461,3472,3465,5,-2,20,103.97 ,30
20141127,3472,3465,3475,3485,3430,3436,3466,-29,1,56,291.20 ,54
20141128,3436,3466,3408,3409,3399,3399,3402,-67,-64,16,81.65 ,66
20141201,3399,3402,3367,3367,3231,3231,3237,-171,-165,242,1175.33 ,240
20141202,3231,3237,3378,3398,3311,3398,3378,161,141,352,1784.02 ,152
20141203,3398,3378,3399,3500,3399,3472,3457,94,79,126,653.42 ,132
20141204,3472,3457,3504,3537,3475,3495,3498,38,41,74,388.29 ,118
20141205,3495,3498,3534,3549,3470,3509,3506,11,8,58,305.05 ,106
20141208,3509,3506,3530,3530,3451,3459,3482,-47,-24,48,250.72 ,110
20141209,3459,3482,3501,3515,3497,3515,3505,33,23,12,63.11 ,110
20141210,3515,3505,3548,3680,3548,3680,3623,175,118,72,391.34 ,114
20141211,3680,3623,3688,3734,3650,3676,3670,53,47,82,451.47 ,130
20141212,3676,3670,3648,3710,3648,3668,3677,-2,7,216,1191.59 ,122
20141215,3668,3677,3696,3696,3630,3664,3682,-13,5,170,939.06 ,252
20141216,3664,3682,3645,3647,3503,3525,3567,-157,-115,78,417.43 ,284
20141217,3525,3567,3585,3585,3454,3460,3483,-107,-84,70,365.76 ,272
20141218,3460,3483,3443,3520,3412,3497,3469,14,-14,50,260.18 ,276
20141219,3497,3469,3527,3533,3491,3498,3510,29,41,36,189.56 ,274
20141222,3498,3510,3488,3514,3488,3501,3501,-9,-9,10,52.52 ,272
20141223,3501,3501,3502,3502,3421,3440,3455,-61,-46,16,82.94 ,272
20141224,3440,3455,3415,3489,3398,3454,3442,-1,-13,48,247.84 ,274
20141225,3454,3442,3454,3454,3434,3435,3441,-7,-1,8,41.30 ,270
20141226,3435,3441,3487,3487,3487,3487,3487,46,46,2,10.46 ,268
20141229,3487,3487,3502,3505,3490,3496,3497,9,10,24,125.91 ,268
20141230,3496,3497,3487,3487,3468,3476,3476,-21,-21,26,135.58 ,290
20141231,3476,3476,3518,3604,3506,3527,3561,51,85,82,438.05 ,266
20141216,3682,3682,3650,3667,3503,3525,3615,-157,-67,478,2592.42 ,248
20141217,3525,3615,3602,3602,3434,3465,3477,-150,-138,582,3035.99 ,330
20141218,3465,3477,3434,3520,3418,3496,3472,19,-5,306,1593.78 ,370
20141219,3496,3472,3465,3535,3465,3491,3500,19,28,288,1512.08 ,390
20141222,3491,3500,3483,3519,3475,3514,3499,14,-1,170,892.39 ,440
20141223,3514,3499,3511,3511,3424,3440,3455,-59,-44,326,1689.53 ,446
20141224,3440,3455,3397,3486,3397,3454,3439,-1,-16,152,784.31 ,456
20141225,3454,3439,3445,3446,3429,3446,3439,7,0,140,722.30 ,462
20141226,3446,3439,3446,3486,3441,3476,3471,37,32,212,1103.85 ,532
20141229,3476,3471,3515,3515,3485,3504,3498,33,27,178,934.05 ,540
20141230,3504,3498,3493,3509,3463,3489,3486,-9,-12,326,1704.92 ,616
20141231,3489,3486,3489,3600,3489,3552,3548,66,62,488,2597.28 ,746
